Creature ID,Birth Time,Death Time,Life Time,Generation,Speed,Smell Radius,Full,Angle Change
0,0,9141,9141,0,0.01,3,10,0.5
1,1,2200,2199,1,0.01718009,3.671639,8.126643,0.5338844
2,438,2902,2464,2,0.01796688,4.371847,9.837933,0.430017
3,1600,5589,3989,1,0.005518355,1.682397,13.69551,0.5697999
4,2727,8833,6106,1,0.006612896,4.448099,11.75056,0.4913063
5,5916,13917,8001,1,0.005604814,3.295448,9.540484,0.5861649
6,6939,8134,1195,1,0.01434311,1.593017,5.134609,0.5663702
7,6997,8641,1644,2,0.009650582,1.917437,5.503426,0.6731367
8,7126,9437,2311,2,0.008309496,4.365097,4.860718,0.3108036
9,7182,9589,2407,3,0.0040043,2.849146,6.760413,0.4067218
10,7484,9542,2058,2,0.01698118,1.593827,3.033484,0.2913617
11,7544,7746,202,3,0.0228957,1.614924,2.5348,0.2602997
12,7634,8790,1156,4,0.02604967,2.248379,1.843845,0.2675794
13,7642,10462,2820,3,0.01136431,2.935449,6.628966,0.4589542
14,7663,7710,47,5,0.0417047,1.348139,1.519451,0.1900514
15,7839,8338,499,3,0.0155469,2.288561,4.802941,0.5613722
16,7879,8276,397,5,0.01120942,2.946424,1.572487,0.2730082
17,7920,8087,167,6,0.01106568,2.419384,2.101925,0.2782515
18,7962,8050,88,5,0.02292412,2.479177,2.37556,0.3768823
19,8043,8277,234,5,0.0219572,2.606347,2.577393,0.30601
20,8108,8553,445,6,0.007559266,4.405101,2.342717,0.2356979
21,8121,8301,180,5,0.0221592,1.133125,2.064883,0.2210646
22,8147,9265,1118,6,0.04489947,2.05278,3.56417,0.2032961
23,8219,8514,295,7,0.008567126,4.251159,1.980804,0.1245014
24,8247,8504,257,5,0.03274518,2.128667,1.780123,0.3635097
25,8257,8330,73,6,0.03241273,2.942943,1.626651,0.3512087
26,8260,8597,337,7,0.01750334,1.657947,4.251664,0.3014774
27,8277,8391,114,7,0.03255587,1.973137,1.019882,0.3202687
28,8288,8368,80,8,0.01967956,1.93426,0.700959,0.2361079
29,8289,8352,63,9,0.01323829,2.792236,0.5507843,0.1442548
30,8301,8394,93,9,0.02024933,2.712126,1.019135,0.149749
31,8320,8393,73,8,0.01826338,2.461836,1.415147,0.3302971
32,8321,8447,126,10,0.03042286,3.243395,1.300607,0.1151549
33,8338,9687,1349,5,0.0139236,3.143288,2.579902,0.2689469
34,8352,9576,1224,7,0.0238785,1.22357,4.354567,0.1671143
35,8357,8385,28,8,0.03989185,2.654529,0.8745629,0.1705789
36,8371,8695,324,6,0.05093445,1.770463,1.611571,0.2228215
37,8391,8479,88,11,0.01917707,3.747679,1.842032,0.1716914
38,8446,8488,42,6,0.06578147,2.324723,0.9085511,0.241984
39,8447,15785,7338,4,0.01119045,2.773177,8.594455,0.2599564
40,8459,8493,34,7,0.056458,0.8904554,1.674226,0.2513362
41,8469,8503,34,7,0.1343286,1.723198,0.6874407,0.3485753
42,8479,8512,33,8,0.03803027,1.622229,0.4472822,0.4429322
43,8482,9016,534,6,0.0133613,3.320223,1.523335,0.2114092
44,8487,8496,9,8,0.1223564,1.491965,0.6551371,0.4956382
45,8493,8553,60,7,0.035299,1.546775,1.651693,0.1534181
46,8495,8509,14,8,0.07526675,1.826706,0.7584349,0.2694678
47,8495,8540,45,9,0.02650591,1.841779,0.574283,0.4042615
48,8496,8520,24,9,0.02460725,2.028333,0.4904869,0.3191756
49,8543,8685,142,7,0.01489344,4.156,2.275109,0.1927406
50,8544,8686,142,7,0.03730777,2.646692,2.241769,0.2054404
51,8566,8865,299,8,0.01481634,2.191079,3.246857,0.1586716
52,8569,8586,17,7,0.06832162,2.644785,0.9912004,0.1533389
53,8570,8588,18,8,0.06220073,3.153471,1.04154,0.1889141
54,8602,8754,152,6,0.01762011,2.083117,3.801021,0.2911565
55,8604,8872,268,7,0.01363014,1.915127,2.242722,0.1677633
56,8619,9006,387,7,0.05810201,2.068704,1.609494,0.2539917
57,8625,11210,2585,8,0.02286194,1.533289,3.78884,0.1346522
58,8626,8766,140,5,0.01613941,2.738497,1.165327,0.2260203
59,8677,8771,94,7,0.04148461,1.304744,5.0736,0.1065722
60,8678,8787,109,8,0.07816938,2.817826,1.225893,0.2926316
61,8691,8742,51,9,0.07292955,2.416729,1.317188,0.3271335
62,8724,8775,51,9,0.06584598,2.226269,0.9353727,0.3568863
63,8726,8960,234,7,0.01049951,4.678757,1.451328,0.1597212
64,8726,9023,297,8,0.09668633,2.014148,2.191786,0.1384913
65,8737,8752,15,9,0.09333693,2.857188,1.598438,0.2033731
66,8738,8758,20,10,0.1157288,2.644709,1.097638,0.3018878
67,8746,8755,9,11,0.16865,1.842695,0.9215766,0.2397205
68,8759,8793,34,10,0.05673349,2.920959,1.098969,0.1820437
69,8761,9497,736,3,0.02354242,1.328133,3.882521,0.3684371
70,8763,8840,77,7,0.05342741,2.655373,1.961173,0.2093795
71,8764,8985,221,8,0.06169242,2.831509,1.983592,0.2815154
72,8766,8899,133,9,0.1200744,3.964215,1.705385,0.1489682
73,8772,8808,36,11,0.0497096,1.87632,0.935808,0.2366399
74,8775,8904,129,9,0.07341475,2.298103,2.619844,0.1035519
75,8779,8815,36,12,0.05787668,2.325527,0.8848523,0.1437229
76,8780,9037,257,10,0.09579074,5.012016,2.353239,0.2172233
77,8790,8833,43,13,0.06582563,1.67499,1.027203,0.138599
78,8791,8855,64,8,0.03353148,1.631436,1.708791,0.1295785
79,8795,8858,63,9,0.03688473,3.019875,1.379541,0.08731975
80,8797,8825,28,10,0.0669409,5.123227,0.891789,0.1571857
81,8797,8868,71,14,0.0261764,1.63747,1.341345,0.07032109
82,8797,8864,67,9,0.02373043,2.337118,0.8919752,0.1756678
83,8798,8858,60,11,0.043272,7.378933,0.7758036,0.1806618
84,8798,8940,142,10,0.02499154,2.901175,0.9445326,0.1844954
85,8803,8846,43,11,0.1118387,6.094017,1.431144,0.3217818
86,8803,8978,175,10,0.01957199,1.996673,1.117356,0.2528777
87,8804,9192,388,15,0.01459519,2.009691,1.852081,0.09010173
88,8806,8896,90,10,0.03204843,3.352928,1.938441,0.1082699
89,8806,8844,38,11,0.03245161,4.955301,1.047403,0.1993367
90,8807,10456,1649,6,0.00386102,3.265685,2.341166,0.224027
91,8807,8875,68,12,0.08296701,5.426002,1.035728,0.2643225
92,8808,8835,27,13,0.1215305,3.458275,1.159094,0.3059328
93,8809,8991,182,8,0.008664981,3.523392,1.248826,0.1519048
94,8809,8855,46,12,0.02774543,6.73307,0.6935796,0.1701855
95,8812,8850,38,13,0.09178183,3.189885,1.401096,0.3299418
96,8814,8859,45,14,0.07812159,1.731131,1.430514,0.1957166
97,8816,8882,66,10,0.06146779,4.850617,1.763688,0.2171755
98,8818,8863,45,11,0.04257733,4.379933,1.038346,0.3136189
99,8819,9005,186,4,0.0212771,1.017351,4.301539,0.4949562
100,8819,8891,72,11,0.01694399,2.159861,0.9425288,0.1066145
101,8821,8883,62,11,0.07519163,2.889777,2.330173,0.1967206
102,8824,9014,190,11,0.01389252,4.158486,1.169557,0.1411659
103,8825,8857,32,8,0.06556473,1.592099,1.154494,0.1677669
104,8827,9010,183,13,0.07690465,6.072195,1.2103,0.2783392
105,8829,8954,125,10,0.2114017,4.981316,2.307154,0.2196041
106,8830,9187,357,9,0.08721095,2.752439,3.101577,0.1509376
107,8830,8869,39,12,0.04689484,6.679925,1.05643,0.2025554
108,8833,8856,23,14,0.0613641,6.374429,1.204108,0.3539591
109,8835,9239,404,15,0.1146657,1.755311,2.096743,0.1502678
110,8837,8877,40,13,0.08929942,8.029826,1.401174,0.235135
111,8847,9015,168,9,0.02657821,1.536985,2.523445,0.1647539
112,8853,9034,181,7,0.01261181,4.837137,1.679572,0.1790918
113,8854,8889,35,11,0.1444555,6.846014,1.499446,0.1809721
114,8858,8909,51,11,0.09366505,5.333921,1.722425,0.2333865
115,8858,8915,57,11,0.02022403,2.727553,0.6911526,0.188884
116,8859,8959,100,13,0.0564317,3.40734,1.382715,0.1645177
117,8862,8938,76,16,0.1224263,1.820024,1.522354,0.08419367
118,8862,8886,24,12,0.1757121,3.945927,1.521783,0.1198195
119,8863,9064,201,8,0.08994652,2.753586,1.847378,0.2452417
120,8863,8937,74,9,0.1178393,2.82321,1.873485,0.1276259
121,8864,8889,25,10,0.08295075,5.848832,1.247992,0.2131117
122,8864,8957,93,12,0.1055707,5.720285,1.729187,0.2936321
123,8865,8889,24,17,0.1207821,2.639176,1.146468,0.08626986
124,8874,8886,12,13,0.1654162,5.833536,1.54684,0.07442281
125,8876,9372,496,10,0.1457815,2.281939,4.6133,0.203565
126,8877,8888,11,18,0.2452085,1.804114,0.6875846,0.07669692
127,8878,9020,142,13,0.1408221,7.306909,1.871074,0.3458829
128,8879,8910,31,11,0.08782748,7.277742,2.637638,0.1607754
129,8882,9006,124,8,0.01544635,6.276925,1.822512,0.1225626
130,8883,8890,7,19,0.1795324,1.295538,0.6417742,0.09321559
131,8884,8910,26,9,0.0803798,3.924012,2.084771,0.1599144
132,8885,8961,76,14,0.05097664,4.68105,1.120836,0.12277
133,8886,8894,8,17,0.2438677,1.278786,1.104016,0.06720525
134,8886,8913,27,10,0.07556821,3.659627,1.300063,0.08430147
135,8888,8943,55,12,0.0350909,4.893785,2.317389,0.3454558
136,8890,9047,157,14,0.06117909,5.157407,1.765198,0.3647666
137,8891,8997,106,14,0.07820563,5.312585,2.711807,0.4686631
138,8894,9035,141,12,0.01175779,2.839381,0.8936155,0.1403523
139,8894,8977,83,16,0.1394061,1.62736,2.776851,0.08984442
140,8895,9067,172,11,0.01814431,2.844826,1.214598,0.1143713
141,8896,8930,34,13,0.09001972,4.126429,0.9661976,0.2238354
142,8897,8923,26,14,0.06993605,4.839395,0.8931882,0.2078268
143,8900,9020,120,15,0.05402753,4.534453,1.320957,0.1209328
144,8903,8941,38,15,0.1286491,6.089481,0.9000714,0.1778408
145,8904,8926,22,14,0.05989843,3.64867,1.213575,0.1333435
146,8906,8924,18,16,0.09074804,6.156859,0.7054944,0.1905314
147,8907,9342,435,11,0.1604103,6.862521,2.240398,0.179615
148,8907,8948,41,17,0.1344377,2.587283,0.9450977,0.05163422
149,8911,8987,76,7,0.06432351,1.921032,2.059544,0.1425905
150,8913,8970,57,16,0.02585602,5.616365,1.585258,0.1179435
151,8915,8966,51,15,0.02843198,4.69505,1.332337,0.1010452
152,8915,8929,14,16,0.1548969,8.519171,0.8004427,0.2371714
153,8916,8989,73,10,0.08656894,3.243309,1.594559,0.1648094
154,8917,9176,259,9,0.05727166,1.314922,2.762343,0.1060119
155,8917,8940,23,13,0.1084688,2.957687,1.062143,0.4136927
156,8918,8931,13,14,0.08124749,5.767653,1.261298,0.1150305
157,8918,9008,90,12,0.1303758,8.775831,1.757407,0.1481766
158,8918,8927,9,18,0.1415669,1.879308,0.8938667,0.03205678
159,8919,8937,18,10,0.1519212,1.705969,1.185572,0.1199876
160,8920,8953,33,17,0.08294789,11.13414,0.9269777,0.3486735
161,8920,9195,275,11,0.1175515,2.011673,1.778589,0.1386194
162,8921,8944,23,14,0.07192997,5.323709,1.081787,0.1973842
163,8923,8964,41,16,0.0757052,7.047641,0.8011196,0.2504237
164,8924,8938,14,14,0.1649743,1.739755,0.7197943,0.2738964
165,8925,8976,51,17,0.1401854,1.226455,3.596153,0.04981976
166,8925,8958,33,18,0.05654176,10.1939,1.112865,0.5182341
167,8925,8935,10,15,0.2112425,1.478196,0.7801199,0.3289227
168,8926,8995,69,8,0.09925559,1.025974,1.541447,0.1251883
169,8926,8956,30,11,0.165595,2.357606,1.098819,0.1393797
170,8927,8946,19,14,0.05082015,3.330411,0.8481801,0.186006
171,8928,8961,33,15,0.0268039,2.592314,0.678703,0.1094161
172,8929,9008,79,19,0.108244,13.47198,1.297037,0.5306388
173,8929,8939,10,16,0.1343748,1.545229,0.4535589,0.3911461
174,8929,8948,19,9,0.05916933,1.477572,0.8261569,0.1611178
175,8929,8950,21,12,0.1326414,2.567122,0.8363236,0.124565
176,8930,9208,278,9,0.03596622,3.435083,2.647871,0.1227497
177,8930,8997,67,10,0.02590095,1.898241,1.224262,0.2109891
178,8931,9085,154,10,0.04251076,1.998878,2.071958,0.2163326
179,8931,8937,6,15,0.2063268,1.357415,1.065851,0.3486975
180,8932,8938,6,16,0.2180026,7.043039,0.91951,0.2076523
181,8932,8939,7,17,0.1200659,1.371324,0.357741,0.2725766
182,8933,9018,85,14,0.04943231,9.842554,2.789828,0.2963148
183,8933,8937,4,17,0.1918854,0.9859026,0.3513227,0.4475503
184,8933,8938,5,18,0.08244682,1.260038,0.2075625,0.3127255
185,8934,8949,15,14,0.09315799,6.864563,1.537901,0.3398744
186,8934,8938,4,19,0.11046,1.7417,0.2811607,0.2383527
187,8936,8954,18,17,0.06483506,6.323809,1.033434,0.2600299
188,8937,8960,23,13,0.07995517,3.675062,0.8939555,0.1972229
189,8937,8990,53,15,0.0318634,3.07523,1.160848,0.1679427
190,8938,8964,26,12,0.1067193,9.601445,1.879693,0.1334054
191,8938,8944,6,18,0.2460607,2.47535,0.908054,0.04117823
192,8938,8956,18,18,0.06901854,14.96406,0.6206137,0.4814355
193,8938,8974,36,14,0.04825506,2.638992,1.088511,0.2563901
194,8940,8950,10,11,0.3074701,6.828015,3.146906,0.2855664
195,8940,8979,39,11,0.05631649,1.660103,1.262501,0.09456201
196,8941,9131,190,8,0.04866837,1.926776,1.373668,0.1657713
197,8941,8952,11,13,0.1042243,2.264811,1.055484,0.1147665
198,8942,9044,102,16,0.01772546,4.237475,1.484508,0.2381541
199,8943,9009,66,14,0.04447605,4.933128,0.9642797,0.2675101
200,8945,8975,30,13,0.08157133,7.569617,1.442458,0.1017586
201,8946,9067,121,11,0.0107257,1.284506,1.341508,0.2411287
202,8946,9228,282,17,0.009222037,4.857088,0.8825685,0.1784938
203,8947,9067,120,8,0.06655516,1.614797,2.076371,0.1009668
204,8947,8961,14,12,0.1551388,3.255993,1.051134,0.1427485
205,8947,9101,154,15,0.07579486,3.719538,1.352714,0.3653576
206,8948,8970,22,17,0.05209994,7.263738,1.181923,0.2669177
207,8948,9016,68,11,0.0339495,2.764608,2.356529,0.1893197
208,8949,8989,40,16,0.05563552,5.136789,0.9825925,0.1380335
209,8949,8988,39,13,0.05698094,8.209562,1.311923,0.09254763
210,8952,8968,16,13,0.1581556,3.907966,0.580579,0.09394915
211,8954,9009,55,9,0.02832156,1.535316,0.8855443,0.1046228
212,8954,8969,15,14,0.120885,10.82176,1.208561,0.1412534
213,8957,9017,60,11,0.04502823,6.113049,1.349596,0.1151688
214,8958,9028,70,17,0.03505467,4.738307,0.9187712,0.1466634
215,8960,8973,13,14,0.082194,3.584369,0.6674873,0.1325197
216,8961,9158,197,12,0.07346042,8.975533,2.274542,0.1139346
217,8962,9001,39,15,0.05187358,7.202364,0.9855532,0.191461
218,8963,9288,325,14,0.04290478,5.723905,1.671832,0.3658497
219,8963,9013,50,14,0.0961958,4.997628,1.096267,0.230809
220,8967,9091,124,11,0.1555341,1.895345,2.775403,0.2668294
221,8967,8974,7,20,0.1682572,7.307066,0.6586709,0.3197542
222,8968,8975,7,21,0.140947,6.293178,0.5673667,0.388576
223,8969,9062,93,12,0.0955676,1.966115,1.621332,0.117916
224,8971,8989,18,16,0.05471018,2.464572,0.7026465,0.2100969
225,8972,9027,55,12,0.09582288,2.026943,2.299216,0.2402276
226,8972,8989,17,17,0.05410696,2.013961,0.7576302,0.1737102
227,8973,9019,46,12,0.04286302,7.650756,1.376148,0.0689186
228,8974,9036,62,13,0.1025207,8.421005,2.209185,0.1146925
229,8976,9482,506,15,0.1000862,7.354358,2.119089,0.4959279
230,8976,8995,19,16,0.03621345,9.305721,0.5406004,0.1405441
231,8977,8987,10,17,0.07179648,11.00532,0.6140853,0.0988654
232,8978,9018,40,9,0.1690135,1.097482,1.738178,0.1182887
233,8978,9009,31,9,0.06799365,0.7241976,0.8289512,0.1124675
234,8978,8988,10,15,0.1470369,2.630867,1.371543,0.1553633
235,8979,9052,73,9,0.08596464,1.008249,3.00212,0.1122587
236,8980,8995,15,15,0.04787443,6.77406,0.4866024,0.3714275
237,8981,9202,221,13,0.09091149,13.31855,1.617625,0.128293
238,8981,9011,30,16,0.01996138,5.290881,0.5748863,0.4373958
239,8982,9000,18,10,0.2384218,1.42398,1.491785,0.1046146
240,8984,9016,32,10,0.05254206,1.066975,0.7836199,0.1615405
241,8990,9037,47,13,0.1711445,6.213363,2.409065,0.1512372
242,8991,9029,38,11,0.07113108,3.104386,1.540369,0.2603505
243,8991,8997,6,11,0.446624,1.186123,1.630558,0.1262664
244,8992,9125,133,10,0.03953508,1.707353,2.616859,0.07170315
245,8992,9014,22,18,0.06030237,5.189102,0.7229916,0.2151081
246,8994,9300,306,10,0.07821755,2.792049,2.334188,0.08743148
247,8994,9012,18,20,0.1988389,13.3435,0.8931825,0.7118616
248,8994,9104,110,14,0.1308548,9.341991,2.420078,0.1541569
249,8995,9109,114,9,0.07119614,4.003287,2.46014,0.2371902
250,8998,9291,293,9,0.05177712,1.46507,2.973367,0.1593019
251,8998,9012,14,13,0.1343642,1.52871,0.9625789,0.1755916
252,8999,9376,377,7,0.0209366,1.674267,3.480696,0.230348
253,8999,9022,23,21,0.1382343,7.826812,0.5672947,0.5972695
254,9003,9020,17,14,0.1393919,10.24212,1.899681,0.259505
255,9004,9017,13,22,0.05794998,7.786429,0.285089,0.5508807
256,9005,9019,14,23,0.04912753,5.858809,0.4193299,0.4316692
257,9006,9202,196,11,0.1009068,2.718062,4.70455,0.176314
258,9006,9071,65,16,0.03246981,4.873336,1.09387,0.3690771
259,9006,9094,88,11,0.06362222,2.844047,2.87587,0.06532349
260,9006,9019,13,21,0.1656631,18.43954,0.5163121,0.9056119
261,9007,9047,40,15,0.0471068,7.27454,1.096414,0.2743561
262,9010,9040,30,11,0.0850752,5.449222,1.499635,0.1877639
263,9011,9046,35,22,0.08023947,16.60593,0.7326059,0.7336136
264,9013,9039,26,14,0.09694749,8.561594,1.32535,0.07073535
265,9013,9145,132,15,0.1656137,6.452258,2.799949,0.123763
266,9013,9026,13,22,0.04693238,8.415742,0.4478743,0.5281633
267,9014,9153,139,16,0.02515362,5.056344,1.614243,0.2167411
268,9014,9021,7,23,0.0948319,11.14293,0.2936208,0.4076733
269,9015,9049,34,15,0.05730182,4.360245,2.276385,0.3402332
270,9016,9037,21,12,0.09760262,3.92842,1.498032,0.1536131
271,9017,9051,34,23,0.03975001,13.68889,0.9269688,0.6465049
272,9018,9105,87,9,0.1801901,2.355989,2.018928,0.1762846
273,9019,9042,23,15,0.04282418,7.317961,0.8491808,0.04692353
274,9020,9051,31,14,0.05565733,17.47014,1.225336,0.1284217
275,9020,9101,81,16,0.05301131,5.901577,1.060241,0.05276173
276,9021,9264,243,10,0.03443028,1.672492,2.877563,0.1264393
277,9021,9044,23,13,0.1888004,1.133019,1.449758,0.06196368
278,9021,9141,120,14,0.1184878,8.899508,2.196005,0.1626047
279,9025,9055,30,11,0.08838178,2.497132,2.851707,0.2995427
280,9025,9124,99,17,0.02472663,3.904633,0.8473131,0.2470176
281,9027,9336,309,13,0.07993084,7.968242,3.283056,0.1199214
282,9029,9068,39,9,0.06415949,1.961344,2.859865,0.05663738
283,9032,9132,100,23,0.07858066,19.19698,1.096229,0.7538178
284,9033,9059,26,14,0.1672275,1.698743,1.31599,0.08165649
285,9034,9504,470,10,0.09421774,3.452219,2.733381,0.1685746
286,9034,9043,9,12,0.3011941,7.13241,2.871167,0.1413002
287,9034,9113,79,9,0.02346564,2.620897,1.250596,0.1600695
288,9040,9064,24,24,0.08012085,9.651894,1.158426,0.6044148
289,9044,9461,417,11,0.08102425,2.533824,2.94074,0.06794599
290,9045,9059,14,25,0.0590838,8.551997,0.6616191,0.3286791
291,9046,9078,32,14,0.0531177,17.5523,0.8428234,0.1038166
292,9046,9492,446,12,0.08054259,3.967444,4.017327,0.07559051
293,9046,9058,12,26,0.06421458,4.475357,0.6312345,0.2878016
294,9047,9061,14,15,0.2535289,2.155257,0.952606,0.1105322
295,9049,9373,324,16,0.07068316,2.974936,1.782284,0.1898007
296,9050,9264,214,15,0.05651971,13.24808,2.074975,0.1719353
297,9050,9054,4,16,0.3095583,1.984678,0.5377269,0.09072059
298,9051,9065,14,17,0.1389479,1.254419,0.6639525,0.07061896
299,9052,9088,36,9,0.04213345,1.57711,1.780084,0.1984749
300,9056,9101,45,17,0.04846787,3.760222,0.9565073,0.05012721
301,9056,9067,11,16,0.3232204,1.384795,1.233055,0.09820548
302,9057,9063,6,18,0.195373,1.315418,0.7577177,0.07245032
303,9063,9204,141,11,0.06409527,2.07275,2.136132,0.2241985
304,9068,9212,144,24,0.06470338,14.70698,1.60665,0.6329121
305,9070,9130,60,17,0.03361784,2.225444,2.423784,0.1473858
306,9071,9113,42,12,0.06992061,1.313454,2.923573,0.2997101
307,9071,9205,134,14,0.06768401,10.86527,1.864778,0.1567674
308,9071,9106,35,18,0.0408602,2.542191,1.160542,0.06695653
309,9076,9088,12,12,0.2582475,4.270303,2.819212,0.1336377
310,9076,9187,111,13,0.04077961,13.37755,2.893438,0.1391717
311,9077,9097,20,17,0.06288503,3.755877,1.515611,0.04655322
312,9079,9108,29,16,0.0571407,2.850245,1.383098,0.2183471
313,9080,9089,9,10,0.3394127,2.390564,1.293585,0.1750431
314,9080,9358,278,11,0.04935531,2.231255,2.384989,0.1565722
315,9081,9220,139,18,0.01368517,3.072663,0.6123408,0.3066484
316,9083,9112,29,11,0.2457981,2.167648,5.346327,0.1778994
317,9083,9106,23,24,0.05298685,22.31858,0.8473598,0.7185285
318,9083,9107,24,11,0.2612202,1.294709,1.793632,0.172095
319,9086,9182,96,15,0.04608519,7.855954,3.199109,0.1452964
320,9089,9541,452,12,0.05206463,2.911123,3.321658,0.1608951
321,9091,9869,778,12,0.08997212,3.344719,6.266607,0.1255284
322,9091,9097,6,12,0.4257253,0.6917031,1.354285,0.09756926
323,9092,9109,17,10,0.141061,3.3301,2.177458,0.1771596
324,9094,9222,128,9,0.06111239,1.168665,1.827495,0.1741607
325,9095,9128,33,11,0.08416842,2.982764,1.263688,0.1002411
326,9096,9233,137,16,0.08083706,12.74176,2.925689,0.1868713
327,9101,9342,241,16,0.08238212,8.291377,1.931547,0.1833439
328,9104,9468,364,12,0.06252865,1.267652,2.953532,0.1561226
329,9105,9132,27,12,0.04164294,1.664542,0.9550935,0.08491402
330,9105,9273,168,18,0.00673207,2.497248,1.096655,0.1787967
331,9106,9139,33,12,0.06547911,2.799764,1.528612,0.07237068
332,9106,9156,50,13,0.02068839,1.42518,1.044557,0.1250531
333,9110,9285,175,15,0.06829097,7.585564,2.589386,0.1811853
334,9112,9135,23,24,0.1530974,20.17106,0.7932912,0.6176088
335,9113,9294,181,14,0.03308553,11.95724,1.94461,0.1187664
336,9113,9148,35,13,0.1236889,2.870224,1.327429,0.09132472
337,9114,9235,121,11,0.06502004,2.761482,1.639504,0.2359555
338,9115,9340,225,11,0.02613067,1.251438,3.074604,0.07680769
339,9118,9297,179,16,0.1008716,2.450128,2.309815,0.2177805
340,9119,9127,8,25,0.1703168,12.58279,1.112518,0.3389569
341,9119,9143,24,14,0.0920334,2.01722,1.131185,0.1167531
342,9120,9191,71,16,0.04106237,7.109951,1.262391,0.1751543
343,9121,9323,202,13,0.1174044,7.099309,2.344527,0.06100088
344,9122,9152,30,17,0.08363043,3.795418,1.080929,0.1793301
345,9123,9152,29,25,0.07243709,8.022566,2.389699,0.4324716
346,9127,9142,15,25,0.1394369,10.96967,0.9235291,0.5837351
347,9127,9138,11,15,0.1396962,1.266527,1.645163,0.06637918
348,9130,9163,33,18,0.06306126,3.295508,1.090899,0.1186234
349,9133,9149,16,26,0.1148786,15.80654,0.9346917,0.577211
350,9133,9161,28,19,0.06746621,4.619463,0.6925809,0.1211321
351,9134,9158,24,17,0.09500431,10.26849,2.616544,0.09315766
352,9134,9167,33,20,0.09414738,4.951436,0.6917511,0.06198826
353,9135,9205,70,19,0.008497288,2.709705,0.3633382,0.3388248
354,9136,9154,18,27,0.1501939,18.29163,0.7574102,0.8240578
355,9136,9175,39,20,0.007685166,1.948532,0.2708314,0.2843194
356,9137,9184,47,21,0.00612666,2.36732,0.1630471,0.1795536
357,9140,9347,207,11,0.08209968,3.801579,2.664088,0.1154561
358,9140,9228,88,12,0.04357605,3.415923,1.978921,0.148986
359,9141,9176,35,12,0.115064,2.115517,1.687042,0.07992691
360,9142,9379,237,15,0.02822396,10.18961,1.626117,0.09928462
361,9142,9221,79,17,0.09321803,7.470721,2.499195,0.1665802
362,9142,9178,36,20,0.08340332,4.663136,0.7731379,0.1159568
363,9145,9200,55,16,0.11916,1.70311,2.188262,0.2194562
364,9145,9161,16,21,0.1179416,5.731543,0.8783081,0.08240053
365,9147,9318,171,25,0.06032237,12.31777,1.875636,0.58893
366,9147,9153,6,28,0.1940902,27.34322,0.4328118,0.4710495
367,9148,9327,179,16,0.1039441,4.860133,1.759966,0.6939448
368,9150,9201,51,22,0.06214188,5.683811,0.6735765,0.1171722
369,9151,9207,56,17,0.07644942,7.268117,1.305035,0.5674503
370,9152,9180,28,17,0.1523422,1.380659,2.441821,0.3234043
371,9152,9210,58,21,0.02887952,6.105075,1.152986,0.1703517
372,9153,9217,64,17,0.02412225,7.053905,0.9380233,0.2013585
373,9155,9179,24,21,0.07354918,4.749013,0.7834494,0.05194807
374,9155,9397,242,18,0.02443355,7.214069,1.445745,0.5060349
375,9156,9210,54,10,0.03742065,1.463634,1.410587,0.08731374
376,9156,9220,64,22,0.02452601,6.894362,0.821713,0.1134107
377,9157,9201,44,16,0.0974614,18.46382,1.917968,0.1190757
378,9157,9331,174,13,0.05474101,1.838607,3.01991,0.08622782
379,9160,9309,149,13,0.05031822,1.066247,3.542223,0.1830372
380,9160,9188,28,22,0.04913112,5.865033,1.057757,0.05420139
381,9162,9757,595,12,0.04792535,3.322458,3.450757,0.1336906
382,9162,9181,19,17,0.2386801,2.263768,2.443437,0.2821592
383,9162,9228,66,18,0.1790391,1.081236,2.707497,0.4443169
384,9163,9181,18,21,0.06846303,4.980765,0.8470686,0.09038085
385,9164,9195,31,23,0.03845573,2.994658,0.9256654,0.06328567
386,9170,9312,142,16,0.0255078,9.342071,0.8649358,0.1115889
387,9170,9210,40,17,0.05351515,4.855731,1.96722,0.5343211
388,9172,9238,66,12,0.1478266,4.640437,2.735875,0.1443478
389,9173,9233,60,11,0.167463,3.405553,2.936383,0.1298937
390,9176,9247,71,17,0.06443872,4.198255,1.790602,0.2066365
391,9176,9221,45,12,0.05341407,1.634643,1.077727,0.2807231
392,9177,9231,54,17,0.04738493,2.456481,1.336334,0.2805256
393,9178,9190,12,12,0.165327,1.86796,1.108309,0.1500648
394,9178,9281,103,15,0.04610841,7.077928,1.549752,0.4126827
395,9178,9257,79,25,0.09934451,12.67828,2.377057,0.7306772
396,9184,9203,19,23,0.05482815,8.060133,0.6384295,0.1265045
397,9185,9491,306,11,0.125362,3.106742,4.463786,0.198789
398,9185,9253,68,18,0.02840748,2.914148,1.454764,0.2170731
399,9187,9305,118,13,0.114972,3.934587,1.766563,0.1472819
400,9191,9235,44,10,0.0735283,2.10898,2.163802,0.1503982
401,9191,9257,66,17,0.03034871,11.38319,1.012511,0.1436863
402,9194,9212,18,13,0.08176745,1.845518,0.8580128,0.1811668
403,9195,9239,44,15,0.04137148,5.84208,1.520344,0.5007514
404,9195,9280,85,18,0.02368792,2.483443,1.008547,0.4103652
405,9196,9424,228,14,0.2074105,5.093319,2.479436,0.1625186
406,9198,9296,98,16,0.07964061,7.177774,2.312387,0.251707
407,9199,9243,44,12,0.1709111,5.671854,1.421214,0.1526349
408,9202,9270,68,17,0.0614756,6.885637,1.714919,0.1387549
409,9202,9253,51,12,0.2228872,1.746993,3.807963,0.1882685
410,9202,9355,153,18,0.02155138,10.08773,1.026777,0.168868
411,9203,9278,75,14,0.1022658,3.799268,2.698333,0.0571718
412,9203,9231,28,13,0.07568815,4.279837,0.7762008,0.209109
413,9204,9236,32,14,0.03283988,3.949694,0.739886,0.3036973
414,9207,9400,193,16,0.05779595,6.577582,2.468976,0.6216591
415,9207,9381,174,19,0.01230376,11.89821,1.149611,0.1383678
416,9208,9262,54,12,0.08538526,3.479295,2.629713,0.2541708
417,9208,9353,145,19,0.02553532,2.385736,1.230861,0.3461004
418,9211,9482,271,13,0.05613178,1.578924,3.874713,0.2318943
419,9211,9257,46,19,0.1080505,1.347631,3.955453,0.230208
420,9211,9271,60,26,0.04128915,17.80376,3.24591,0.8478671
421,9212,9242,30,17,0.08988814,2.769409,0.9350663,0.8042447
422,9215,9289,74,16,0.03715909,6.307935,2.213288,0.1976741
423,9215,9373,158,12,0.02066936,1.721817,4.51955,0.06766801
424,9215,9339,124,12,0.09760223,3.503184,4.519272,0.2184835
425,9215,9228,13,14,0.2395836,4.27918,1.017679,0.128443
426,9215,9235,20,14,0.05730664,6.13856,0.8085745,0.1868142
427,9219,9265,46,12,0.0321136,2.248314,1.292873,0.2001565
428,9220,9290,70,13,0.02029461,3.360359,1.729546,0.2216014
429,9221,9346,125,16,0.0697243,4.829874,1.519187,0.5639135
430,9221,9237,16,15,0.3880976,3.079859,1.306874,0.06664845
431,9223,9262,39,16,0.02988149,9.801315,1.051404,0.1868493
432,9224,9305,81,17,0.01336901,11.2899,0.4722539,0.1153482
433,9224,9319,95,17,0.04052328,8.663325,1.148079,0.1165303
434,9225,9267,42,18,0.008415243,11.75983,0.3198412,0.06135705
435,9226,9284,58,18,0.0346825,2.44977,0.7597843,0.5979704
436,9226,9263,37,19,0.009375365,15.91553,0.4299798,0.07601321
437,9227,9317,90,17,0.05127298,3.582669,1.999744,0.3939738
438,9229,9764,535,15,0.07040668,3.701275,2.898902,0.1055602
439,9231,9346,115,17,0.06439862,3.976192,1.086022,0.7685226
440,9232,9262,30,14,0.0902212,9.043909,2.328417,0.03214248
441,9232,9259,27,16,0.2294725,3.557963,1.000872,0.0505181
442,9233,9244,11,13,0.3613409,2.841005,1.873959,0.1289731
443,9234,9353,119,11,0.1602953,3.133595,5.387241,0.1794695
444,9235,9240,5,17,0.354121,2.967343,0.7831989,0.05002893
445,9236,9265,29,14,0.2328599,3.487371,1.095011,0.1448284
446,9237,9366,129,15,0.01550665,5.63109,1.809607,0.5045841
447,9239,9274,35,16,0.05567471,8.782489,1.345856,0.6060756
448,9240,9398,158,13,0.03561521,2.228926,4.636008,0.09118892
449,9241,9325,84,16,0.02228674,6.256149,1.335938,0.05861635
450,9241,9262,21,18,0.1178036,4.149128,0.7964167,0.7815502
451,9241,9259,18,15,0.2310366,4.008802,1.340594,0.1159263
452,9242,9363,121,12,0.1039645,6.279848,2.946552,0.1823153
453,9243,9316,73,15,0.02609732,4.928617,1.794752,0.1900013
454,9243,9253,10,16,0.3767268,2.114436,0.8012384,0.1382292
455,9244,9258,14,19,0.05790728,1.277875,0.5416703,0.8590825
456,9245,9291,46,17,0.05069452,7.79726,1.263336,0.1023333
457,9245,9252,7,17,0.5617501,2.362093,1.188261,0.08929597
458,9245,9258,13,20,0.05504313,1.636424,0.6257863,0.8782421
459,9246,9367,121,20,0.01698209,8.857086,1.469468,0.1780754
460,9247,9500,253,15,0.09886739,5.073694,1.681551,0.06831355
461,9248,9272,24,17,0.1361087,3.556856,0.5656355,0.06606276
462,9249,9724,475,12,0.05321373,2.988249,2.168487,0.06742167
463,9249,9718,469,13,0.09938592,4.125245,3.891073,0.2804773
464,9249,9253,4,17,0.420399,2.857145,0.4414915,0.07487743
465,9250,9289,39,11,0.07230718,4.273065,1.72253,0.2325183
466,9250,9293,43,19,0.04129514,4.899754,0.8941603,1.162508
467,9253,9273,20,19,0.0373911,7.881248,0.5404731,0.1444511
468,9253,9260,7,17,0.1721081,3.839548,0.8291996,0.04158444
469,9253,9311,58,20,0.02777169,6.249682,1.071529,0.7806504
470,9254,9269,15,12,0.1674329,5.587689,1.290519,0.2262277
471,9254,9281,27,18,0.2122542,3.275117,0.7297116,0.05310263
472,9254,9279,25,20,0.03924579,3.988966,0.4924375,0.1940036
473,9258,9299,41,12,0.0606534,5.433125,1.583764,0.225726
474,9258,9267,9,19,0.2833727,3.739701,0.9973204,0.03542523
475,9260,9301,41,17,0.04906734,4.465932,1.768018,0.659873
476,9261,9278,17,17,0.132597,1.742483,1.422516,0.2561652
477,9262,9325,63,18,0.01621736,9.211624,0.2883542,0.1348221
478,9262,9277,15,21,0.04410706,5.557546,0.5267119,0.237457
479,9262,9276,14,20,0.2501406,2.42988,1.448737,0.04471637
480,9263,9309,46,18,0.01214113,8.839722,0.6816097,0.07239731
481,9263,9281,18,21,0.03391261,3.517023,0.6055712,0.2174342
482,9263,9291,28,19,0.02057764,5.025255,0.3148842,0.1708443
483,9263,9274,11,22,0.06177523,3.647787,0.4921259,0.1286449
484,9264,9291,27,17,0.04590541,8.699887,1.070896,0.1119906
485,9264,9273,9,18,0.1240594,2.644188,0.5570894,0.04137041
486,9265,9272,7,19,0.1503017,2.604014,0.3904731,0.03105581
487,9267,9320,53,17,0.1496301,6.636587,2.244084,0.7853476
488,9267,9321,54,14,0.139311,5.239865,2.437191,0.1756883
489,9269,9304,35,13,0.0668727,2.821276,1.33893,0.2150883
490,9270,9333,63,21,0.02621634,7.144749,1.846403,0.2558675
491,9270,9277,7,19,0.3242154,4.630368,0.9266615,0.07461137
492,9273,9278,5,20,0.3049123,2.768696,0.8337096,0.0463445
493,9276,9283,7,19,0.1530553,2.565938,0.9776217,0.06611215
494,9279,9331,52,18,0.03009571,3.760708,0.7415024,0.5696264
495,9280,9353,73,14,0.03395122,4.17913,0.8806843,0.2085172
496,9280,9318,38,19,0.02137585,2.416556,0.4210562,0.7145994
497,9281,9407,126,11,0.184995,1.840379,5.973588,0.2521387
498,9284,9352,68,13,0.07636142,7.785281,2.703213,0.2548928
499,9286,9325,39,14,0.2234505,2.457052,1.446989,0.1424041
500,9286,9321,35,18,0.01932023,4.592862,0.6094275,0.06406788
501,9287,9343,56,17,0.1171752,5.794203,2.840071,0.2214189
502,9287,9307,20,19,0.0361878,5.095139,0.4726108,0.3027685
503,9287,9318,31,19,0.021687,4.339458,0.8962601,0.04050461
504,9288,9460,172,13,0.08881959,1.712805,2.339429,0.1844457
505,9288,9300,12,20,0.06180637,3.546074,0.2873183,0.2966871
506,9289,9317,28,15,0.176192,1.240311,1.115188,0.1222976
507,9291,9440,149,12,0.05799423,4.657931,2.520729,0.1552801
508,9291,9343,52,19,0.01866547,9.236353,0.4251264,0.1314987
509,9292,9327,35,19,0.01532111,11.40984,0.3652259,0.1891069
510,9292,9366,74,14,0.1280294,1.393104,2.204257,0.134268
511,9292,9314,22,20,0.02506593,10.69554,0.4531884,0.1601219
512,9293,9476,183,13,0.02918494,5.626084,2.649777,0.09878127
513,9293,9355,62,15,0.1340106,4.586104,2.194916,0.1594832
514,9294,9479,185,13,0.05760333,2.907513,2.45896,0.08899267
515,9294,9301,7,16,0.1325535,1.757727,0.57111,0.1566536
516,9295,9430,135,14,0.03754959,6.544522,2.19641,0.107436
517,9295,9325,30,17,0.0383893,0.9675032,0.380348,0.2215015
518,9297,9404,107,19,0.01155947,6.280849,0.7074,0.1735133
519,9300,9334,34,15,0.1441661,6.954424,3.037828,0.1364141
520,9301,9338,37,16,0.05076525,6.757842,1.547283,0.048774
521,9303,9315,12,18,0.2161893,7.036222,2.898681,0.7282405
522,9305,9335,30,15,0.2274187,1.532508,1.763153,0.1375102
523,9306,9315,9,16,0.2097165,0.6551065,1.240628,0.06676787
524,9308,9326,18,16,0.1407287,5.987223,2.120817,0.1037087
525,9309,9483,174,15,0.2018413,5.776384,3.013396,0.09236503
526,9310,9325,15,18,0.03799717,0.6704981,0.24005,0.2332387
527,9311,9345,34,12,0.07900491,5.411447,2.086683,0.135092
528,9311,9320,9,18,0.0618531,0.9546336,0.4724447,0.2589871
529,9311,9321,10,19,0.0298168,0.6263469,0.1402964,0.2768937
530,9312,9362,50,12,0.2041554,8.86526,2.529747,0.102352
531,9312,9354,42,20,0.01332009,5.707081,0.3227875,0.1786477
532,9312,9322,10,20,0.02676411,0.884268,0.1604318,0.1971061
533,9313,9346,33,20,0.01685324,5.800869,0.3257687,0.09508023
534,9313,9382,69,21,0.007821385,6.159688,0.424211,0.2492237
535,9314,9527,213,17,0.08904149,1.737403,2.020706,0.09742202
536,9315,9422,107,13,0.07921198,1.692724,4.038615,0.09485631
537,9315,9337,22,13,0.109015,3.034022,2.620498,0.1341009
538,9316,9540,224,14,0.1808645,3.107949,4.189179,0.3038466
539,9316,9421,105,15,0.04063955,7.432087,3.218888,0.06654549
540,9319,9501,182,17,0.04769311,7.965936,3.277041,0.3725401
541,9319,9463,144,12,0.227352,2.498047,7.346745,0.3499175
542,9320,9349,29,15,0.03868477,4.470279,0.9925493,0.2877285
543,9323,9353,30,18,0.04863741,5.891043,0.6780034,1.008593
544,9326,9378,52,16,0.1891756,1.68188,2.183314,0.1804787
545,9328,9362,34,18,0.0789584,1.093574,1.81348,0.07724836
546,9330,9671,341,14,0.0241891,2.501143,1.923456,0.2460388
547,9332,9361,29,13,0.1020331,7.817971,2.142384,0.2010421
548,9334,9649,315,14,0.03218304,1.606339,5.449524,0.2528017
549,9336,9481,145,16,0.06563707,6.383121,1.958697,0.05317228
550,9337,9363,26,16,0.08986831,5.992126,3.251348,0.2215763
551,9337,9406,69,19,0.08700839,1.245246,2.379481,0.108642
552,9338,9461,123,13,0.06953924,4.718605,4.342298,0.04175575
553,9338,9401,63,14,0.05003592,1.518439,1.704783,0.057791
554,9338,9358,20,13,0.2291623,8.70261,2.061859,0.1353694
555,9338,9360,22,14,0.110286,8.261316,1.720086,0.1821907
556,9339,9351,12,16,0.3028105,3.586431,4.457024,0.08581975
557,9342,9573,231,17,0.03535116,1.76541,1.873804,0.1493855
558,9343,9436,93,11,0.05501846,1.966065,3.140895,0.1876802
559,9343,9410,67,14,0.06315369,1.664713,4.88477,0.07019867
560,9344,9375,31,15,0.22535,1.513512,3.213969,0.175762
561,9344,9479,135,17,0.1114936,1.937851,2.214808,0.2155127
562,9344,9774,430,15,0.05109969,3.679085,2.350224,0.3604659
563,9345,9415,70,15,0.1848309,5.198057,3.364308,0.1178449
564,9346,9365,19,15,0.2466854,3.910922,2.471574,0.2143234
565,9347,9356,9,14,0.3132289,8.385849,1.609799,0.132415
566,9356,9395,39,18,0.1719594,1.899028,2.488889,0.3229799
567,9358,10995,1637,9,0.009143891,1.663345,3.131872,0.1403066
568,9362,9371,9,15,0.354884,6.111305,3.060344,0.2127506
569,9362,9495,133,16,0.07191969,4.110736,1.870558,0.04679557
570,9363,9416,53,15,0.07445432,2.180233,1.879261,0.07436284
571,9371,9543,172,14,0.025945,1.477867,3.447881,0.1279005
572,9374,9394,20,16,0.2793674,6.237075,1.939448,0.06263051
573,9374,9406,32,18,0.07211679,2.43153,2.094524,0.1076397
574,9374,9418,44,15,0.2674851,3.097519,2.240145,0.2110163
575,9375,9787,412,14,0.08253945,1.623459,4.794412,0.162332
576,9375,9600,225,16,0.05755479,3.746553,4.033698,0.1304759
577,9378,9387,9,16,0.3844129,3.415672,2.857239,0.1540138
578,9380,9498,118,13,0.05424986,1.725117,7.622771,0.1757599
579,9382,9517,135,17,0.09503038,3.67467,1.287823,0.0614651
580,9394,9469,75,18,0.03220726,3.439835,1.291932,0.07132324
581,9395,9518,123,12,0.1241243,2.508672,2.445968,0.2311764
582,9401,9433,32,13,0.1624808,2.917436,1.740826,0.2032993
583,9404,9501,97,16,0.06100295,5.198417,2.416189,0.101132
584,9407,9598,191,14,0.05358731,2.212232,2.322147,0.1791458
585,9407,9536,129,17,0.02868934,4.99929,2.241384,0.03294185
586,9408,9436,28,16,0.2428242,3.173084,2.317107,0.1460024
587,9409,9479,70,19,0.02227746,4.112875,0.7716171,0.1031571
588,9413,9454,41,18,0.05625117,4.464114,1.027841,0.0333452
589,9414,9515,101,13,0.04202946,2.680486,5.636797,0.1115315
590,9416,9495,79,16,0.05759283,5.138652,2.412821,0.3393146
591,9416,9458,42,16,0.1330403,3.698088,1.275482,0.06836924
592,9416,9505,89,17,0.07426725,8.658584,2.434584,0.030864
593,9417,9577,160,19,0.02297295,3.309186,1.881952,0.08872042
594,9420,9652,232,13,0.1667641,2.882444,4.075926,0.3662714
595,9421,9501,80,17,0.06951027,4.274988,1.002567,0.0744383
596,9422,9598,176,16,0.06267188,4.321269,3.99841,0.08234663
597,9423,9563,140,17,0.07265148,5.491218,3.755967,0.1748697
598,9423,9488,65,19,0.0345848,3.595616,1.361482,0.04582906
599,9425,9498,73,14,0.1164744,2.226691,4.095185,0.2764836
600,9426,9435,9,18,0.1691572,3.418417,0.851652,0.04286576
601,9427,9876,449,15,0.08653601,2.141398,4.792357,0.1658193
602,9428,9741,313,14,0.09043339,1.46234,1.573328,0.07281466
603,9431,9564,133,13,0.07809857,1.827253,1.275514,0.08342923
604,9433,9487,54,15,0.1153565,1.502213,1.07804,0.07188176
605,9434,9539,105,18,0.04784665,0.8845288,1.308287,0.119059
606,9435,9448,13,16,0.2882983,6.376873,3.655521,0.07784545
607,9437,9517,80,16,0.1445822,5.092599,1.173716,0.04621626
608,9438,9601,163,17,0.09693482,2.387107,1.864377,0.05585829
609,9439,9550,111,18,0.04182165,1.590249,2.215573,0.2754189
610,9439,9502,63,18,0.05382658,3.920212,1.454784,0.04976522
611,9441,9459,18,17,0.130311,3.394695,1.357271,0.02613557
612,9443,9452,9,16,0.2060372,2.144444,1.111404,0.07618989
613,9444,9545,101,17,0.1161109,3.294313,2.134986,0.04294858
614,9444,9502,58,18,0.06682287,5.046684,1.39669,0.08144191
615,9444,9521,77,20,0.01939623,2.213075,1.657861,0.02629141
616,9446,9461,15,17,0.1849779,3.458012,0.6841255,0.08126846
617,9446,9505,59,18,0.09631874,3.411572,1.317441,0.0175219
618,9447,9622,175,16,0.07288372,3.444814,2.613554,0.4533974
619,9447,9476,29,13,0.09494865,3.095071,3.433177,0.234091
620,9447,9628,181,18,0.05878105,3.722087,2.528067,0.02184794
621,9451,9517,66,12,0.1059077,1.711259,3.206661,0.1035429
622,9451,9717,266,18,0.05372516,5.456168,2.721555,0.1671301
623,9455,9539,84,19,0.06233087,0.863422,1.238299,0.06573863
624,9455,9494,39,18,0.1078176,2.686518,1.622872,0.072741
625,9455,9463,8,18,0.1218536,3.479403,0.6837021,0.08337334
626,9457,9589,132,18,0.09459204,2.614609,2.705951,0.1103991
627,9458,9491,33,15,0.1362239,1.303735,1.554089,0.1051452
628,9458,9555,97,18,0.08468206,3.259774,1.916871,0.02672255
629,9459,9488,29,18,0.076391,2.284267,2.286451,0.09304161
630,9462,9472,10,16,0.2132385,1.536384,1.344041,0.09637269
631,9463,9511,48,17,0.04154224,3.181108,1.039277,0.06771492
632,9465,9487,22,16,0.09678067,0.891377,1.037677,0.07931653
633,9469,9564,95,14,0.218987,2.3392,5.297447,0.3483752
634,9470,9484,14,17,0.1159371,1.331121,0.7751315,0.08392741
635,9473,9534,61,19,0.1667236,3.259044,2.077286,0.06087531
636,9476,9544,68,18,0.0507435,4.694344,1.718151,0.07519747
637,9476,9489,13,16,0.1621128,0.8098453,1.195715,0.04597719
638,9476,9497,21,18,0.07034791,3.425739,0.7981818,0.08608758
639,9477,9488,11,17,0.1716528,4.197134,1.02731,0.02559994
640,9478,9522,44,18,0.05144268,1.789872,1.85366,0.1369781
641,9479,9503,24,15,0.1027513,1.019316,1.100235,0.06983849
642,9480,9530,50,19,0.0465505,4.277953,2.18882,0.01729454
643,9480,9508,28,17,0.174963,1.103886,1.159478,0.06382696
644,9481,9622,141,17,0.1219442,3.097703,3.083926,0.4546397
645,9484,9585,101,18,0.04073091,5.341319,1.312266,0.07720789
646,9484,9533,49,20,0.1268088,2.985518,1.110478,0.03881189
647,9485,9498,13,16,0.143028,0.8452258,0.8886503,0.04415685
648,9485,9498,13,18,0.1048425,1.545628,1.206764,0.0469908
649,9487,9550,63,19,0.07305816,2.804707,2.549244,0.1957486
650,9489,9541,52,18,0.1564251,3.029962,2.340293,0.02472017
651,9490,9526,36,19,0.07993085,3.93285,0.9198824,0.1053075
652,9492,9510,18,15,0.2501527,2.592945,2.172965,0.3867442
653,9493,9518,25,14,0.07785162,2.097282,1.910447,0.08071731
654,9494,9690,196,6,0.02464025,3.457283,1.548696,0.2112636
655,9496,9508,12,21,0.1221987,4.408371,0.7222804,0.02986042
656,9496,9568,72,20,0.1132121,3.826149,1.20495,0.06838493
657,9496,9568,72,7,0.0347098,4.576817,1.617305,0.2405046
658,9498,9520,22,18,0.08178042,2.590454,0.980406,0.03795223
659,9498,9517,19,18,0.1083241,1.198194,1.204046,0.04823511
660,9498,9506,8,18,0.3196162,1.474404,0.9013262,0.0522717
661,9500,9537,37,19,0.05034934,1.011481,1.010122,0.1214334
662,9500,9610,110,19,0.04717805,3.636117,3.932995,0.07290873
663,9500,9524,24,16,0.2821408,3.519354,1.833024,0.4265887
664,9501,9522,21,21,0.07572137,5.086215,1.681685,0.05507173
665,9501,9508,7,19,0.2338516,1.636584,1.270604,0.0566204
666,9504,9873,369,20,0.02819541,1.170764,1.109255,0.08475375
667,9506,9601,95,18,0.1137327,3.995087,2.083572,0.1039785
668,9507,9539,32,14,0.09777796,1.614937,0.9611652,0.09303153
669,9508,9594,86,16,0.06466232,4.434027,4.289879,0.1117336
670,9508,9585,77,19,0.172359,4.546301,1.750884,0.1397041
671,9509,9523,14,20,0.09946334,4.904353,0.5675852,0.1365304
672,9511,9738,227,20,0.1500607,6.568206,1.861967,0.08267416
673,9512,9647,135,8,0.06447925,5.510049,1.529661,0.3396415
674,9512,9520,8,15,0.1110516,1.035568,0.6635467,0.128546
675,9513,9522,9,21,0.2052671,1.639692,1.063282,0.04748743
676,9513,9523,10,16,0.08300455,1.172752,0.5426089,0.1121483
677,9514,9873,359,15,0.05538633,2.011389,2.332106,0.1237449
678,9514,9655,141,20,0.08724926,4.036862,1.918082,0.179641
679,9516,9544,28,17,0.4512694,1.939134,2.545113,0.3860691
680,9517,9536,19,20,0.1099489,0.6563472,1.209989,0.0889164
681,9518,9688,170,15,0.0190049,3.718378,1.965561,0.173005
682,9519,9542,23,21,0.07923897,2.789104,1.767133,0.04017877
683,9522,9545,23,21,0.05683102,4.46872,0.7707323,0.03261048
684,9522,9622,100,21,0.01907283,0.9757392,1.206488,0.1161174
685,9522,9539,17,21,0.08814248,0.3938316,0.8134899,0.04563034
686,9523,9540,17,19,0.1625937,3.102119,1.507316,0.01597095
687,9525,9551,26,15,0.1634876,0.9301002,1.453357,0.07551654
688,9525,9541,16,20,0.1280906,6.72019,0.9339732,0.07303445
689,9526,9548,22,21,0.1366028,7.584484,1.031764,0.1194898
690,9527,9679,152,17,0.09995652,4.9372,5.022205,0.07896381
691,9527,9563,36,15,0.05789677,1.559097,0.5173497,0.09257463
692,9528,9588,60,22,0.0691718,9.690218,1.513554,0.06066698
693,9529,9905,376,7,0.04907152,4.845748,2.118874,0.2746619
694,9529,9542,13,21,0.1086861,4.977191,1.351079,0.09532043
695,9531,9658,127,14,0.1548931,2.713866,1.783518,0.04205112
696,9532,9592,60,23,0.06445065,7.357823,1.531164,0.08734037
697,9537,9597,60,18,0.1255091,3.209948,2.716881,0.07280625
698,9537,9573,36,22,0.09596904,8.325138,1.145285,0.08356566
699,9540,9635,95,22,0.01631556,1.070788,1.590292,0.1629479
700,9541,9580,39,15,0.06144413,2.126559,1.104628,0.03313757
701,9544,9581,37,19,0.04473324,3.569734,1.114681,0.05936505
702,9544,9552,8,16,0.08530623,1.238465,0.4130448,0.08724392
703,9545,9570,25,14,0.05573139,1.286475,1.555942,0.06888448
704,9545,9599,54,19,0.1124519,2.110166,2.122589,0.08988496
705,9545,9551,6,17,0.1063209,1.372247,0.5137768,0.06848063
706,9546,9598,52,21,0.1523404,5.345956,1.710526,0.03956287
707,9549,9587,38,16,0.05842566,2.19816,1.15375,0.02533692
708,9550,9588,38,9,0.1027673,5.065163,2.137259,0.5078492
709,9553,9611,58,14,0.1800357,3.333295,4.465375,0.3718812
710,9553,9577,24,15,0.07482485,1.10478,1.040852,0.07124931
711,9555,9606,51,17,0.05685663,3.062078,1.609703,0.2457471
712,9555,9595,40,21,0.08709322,3.387127,1.381837,0.05361547
713,9557,9627,70,23,0.05903493,6.840996,1.630764,0.06025222
714,9557,9569,12,17,0.08376227,2.126466,0.5996503,0.01386292
715,9558,9676,118,16,0.09446983,5.378823,3.61674,0.06610385
716,9558,9890,332,19,0.06867681,3.424904,2.265803,0.1258185
717,9558,9573,15,18,0.1252784,1.312613,0.769726,0.01720176
718,9560,9587,27,21,0.04503939,1.352898,1.225888,0.07315189
719,9560,9757,197,21,0.06018633,3.815729,2.269534,0.1530282
720,9561,9722,161,16,0.01499224,3.881962,1.887148,0.1733448
721,9562,9581,19,21,0.2471653,5.364766,1.968327,0.1079279
722,9563,9571,8,19,0.09305739,0.8604081,0.4101166,0.009350725
723,9564,9575,11,20,0.05327328,1.207716,0.4690714,0.01148554
724,9567,9608,41,15,0.1130531,4.03152,1.460968,0.03902125
725,9572,9760,188,16,0.04212144,4.478488,1.923193,0.1991674
726,9573,9648,75,20,0.1325888,5.535625,1.664418,0.1323698
727,9574,9649,75,13,0.08802898,2.521502,2.555272,0.08889721
728,9574,9916,342,14,0.0827466,4.694545,5.129814,0.1950932
729,9574,9597,23,19,0.2166106,3.319598,3.412281,0.05283119
730,9575,9794,219,15,0.01572673,2.399442,2.771973,0.3557359
731,9575,9619,44,20,0.05898262,2.93555,1.969753,0.09142521
732,9575,9752,177,17,0.01439636,4.811007,0.9791868,0.189234
733,9575,9594,19,16,0.1258099,2.643822,1.353337,0.04152604
734,9576,9628,52,18,0.02152841,6.137479,0.7575237,0.212592
735,9581,9747,166,19,0.07778782,3.483332,2.413129,0.08484973
736,9581,9703,122,20,0.03829975,2.159187,2.533014,0.1051414
737,9581,9598,17,17,0.2137585,1.657995,1.92144,0.05444305
738,9582,9647,65,16,0.03673625,2.605697,1.858976,0.1491529
739,9585,9753,168,18,0.008886513,5.712795,1.42723,0.2405434
740,9587,9672,85,21,0.05234508,2.330512,1.494803,0.1260448
741,9590,9799,209,16,0.07370311,4.800012,1.652953,0.109329
742,9594,9727,133,16,0.0186746,2.308975,2.606143,0.3374806
743,9595,9617,22,17,0.06289887,3.34146,0.8441511,0.1620757
744,9596,9641,45,18,0.04425394,2.068264,0.8320308,0.1125831
745,9597,9612,15,15,0.1368034,2.044379,1.202457,0.0646412
746,9601,9656,55,22,0.0449695,3.15799,0.8555808,0.1053758
747,9606,9651,45,13,0.0542981,2.763076,1.266818,0.05881673
748,9608,9684,76,17,0.0264042,4.608053,1.683514,0.1047991
749,9609,9713,104,17,0.0616603,6.568347,2.340465,0.1435288
750,9610,10639,1029,16,0.004735299,3.351814,3.107308,0.2871323
751,9610,9639,29,19,0.02391073,1.950386,0.6218821,0.08380938
752,9611,9644,33,20,0.02034346,2.788133,0.930444,0.0950164
753,9614,9741,127,7,0.0146098,3.258811,0.9996419,0.1475901
754,9614,9739,125,18,0.01598407,5.346935,1.045818,0.08405957
755,9615,9640,25,8,0.05995338,5.718926,1.169051,0.1940798
756,9616,9651,35,21,0.1218427,9.552388,1.953601,0.09048299
757,9616,9690,74,9,0.06244325,4.194744,1.024474,0.111585
758,9621,9682,61,9,0.09507398,3.6089,1.4297,0.3333815
759,9623,9730,107,15,0.07463801,1.053271,1.748571,0.07435228
760,9623,9740,117,21,0.02696991,1.250505,0.9938807,0.105346
761,9623,9661,38,19,0.02178245,3.537794,0.6624609,0.1180566
762,9624,9649,25,20,0.03778157,3.251527,0.9434972,0.1226018
763,9626,9736,110,18,0.06564433,3.373275,5.650914,0.05318121
764,9626,9677,51,20,0.02894953,2.35014,0.762192,0.06147113
765,9627,9756,129,19,0.05330794,3.113888,2.672779,0.1689831
766,9627,9727,100,23,0.02368276,3.208618,0.9539082,0.1474891
767,9627,9670,43,20,0.01714618,2.315791,0.8833851,0.08928518
768,9628,9872,244,21,0.01412608,1.714107,1.266018,0.07170151
769,9629,9693,64,21,0.06600438,2.492037,1.781842,0.2639958
770,9633,9683,50,16,0.09848887,1.318924,2.9876,0.1327587
771,9641,9765,124,15,0.1687249,2.100706,1.534739,0.09968526
772,9642,9651,9,15,0.2792906,2.964625,1.058351,0.02289539
773,9643,9981,338,20,0.06580214,3.513731,2.701178,0.06223669
774,9644,9705,61,13,0.07325909,2.775412,1.763933,0.07204886
775,9645,9752,107,24,0.03222288,3.268103,1.01424,0.210889
776,9649,9963,314,16,0.04075662,1.096007,2.027048,0.05215675
777,9652,9821,169,16,0.08112516,5.147962,3.000219,0.5268143
778,9652,9865,213,14,0.0368585,1.723655,2.414105,0.07578202
779,9653,9793,140,20,0.09534997,4.70478,1.627554,0.1878984
780,9653,9700,47,10,0.08590853,5.317525,1.521607,0.09449854
781,9656,9772,116,21,0.04305501,1.667264,1.235239,0.1177412
782,9656,9675,19,21,0.2355667,4.297558,1.677676,0.05166291
783,9657,9668,11,16,0.172947,3.09158,1.683008,0.06171959
784,9660,9719,59,10,0.05583299,2.718953,0.9781265,0.2415237
785,9661,9690,29,21,0.07450678,4.940853,1.303071,0.1066514
786,9661,9704,43,22,0.06984527,1.891674,0.9083543,0.09934902
787,9662,9716,54,24,0.04290727,3.890803,0.8359864,0.1294637
788,9663,9844,181,22,0.01111998,1.661698,0.6879646,0.110871
789,9664,10435,771,8,0.03584311,6.150225,3.140519,0.1998853
790,9668,9699,31,10,0.103399,4.654304,1.020477,0.06124066
791,9671,9782,111,15,0.03832325,1.356236,1.135096,0.05622229
792,9671,9686,15,21,0.1370065,9.503437,2.64707,0.05593848
793,9672,9716,44,23,0.0982528,1.571356,1.159294,0.1135888
794,9673,9717,44,11,0.01912923,2.347411,0.6160073,0.3004248
795,9674,9785,111,12,0.007255549,1.381241,0.7934883,0.1510705
796,9675,9743,68,18,0.008246718,4.799253,0.4925889,0.1758657
797,9676,9767,91,19,0.006023837,4.749511,0.5481325,0.09202579
798,9677,9692,15,11,0.08593031,3.375794,0.7625936,0.04822581
799,9678,9751,73,17,0.03322457,0.6363016,2.71141,0.03240824
800,9679,9783,104,11,0.06695527,4.182959,1.240733,0.09839498
801,9681,9803,122,22,0.02144108,2.611689,1.507307,0.1834721
802,9682,9748,66,16,0.04069523,3.495108,2.976679,0.2076581
803,9683,9918,235,21,0.08990469,2.979886,1.884345,0.2363574
804,9683,9718,35,23,0.04002837,2.354719,1.047141,0.1050457
805,9685,9734,49,20,0.05647147,4.70504,3.344623,0.06612149
806,9686,9751,65,21,0.04329602,2.153646,1.928256,0.04954541
807,9686,9740,54,25,0.06136644,4.564387,1.251535,0.1592523
808,9687,9759,72,16,0.06953154,2.510871,2.845706,0.08811631
809,9687,9707,20,21,0.09884963,4.50628,1.945307,0.2356287
810,9688,9728,40,16,0.1336861,3.720248,1.911667,0.09749225
811,9688,10197,509,21,0.0147588,0.9964455,1.089799,0.05091191
812,9688,9739,51,11,0.1602002,5.951848,1.248926,0.08287457
813,9690,10194,504,22,0.006861046,1.524,1.832678,0.09819964
814,9692,9731,39,22,0.05726357,1.205869,0.9995387,0.1574236
815,9692,9724,32,12,0.07901463,2.759473,0.8059086,0.1045099
816,9693,9728,35,16,0.1248026,2.960306,1.526628,0.07824306
817,9694,9912,218,17,0.03562059,2.741298,2.441218,0.06581642
818,9695,9964,269,15,0.05381272,1.35041,2.096226,0.09552372
819,9696,9740,44,21,0.1284885,7.344544,2.609811,0.07652201
820,9697,9724,27,11,0.07086255,3.146029,1.174942,0.2705484
821,9697,9975,278,17,0.07337388,4.323818,1.659869,0.06955944
822,9699,9879,180,22,0.01218924,1.64745,2.665987,0.05045531
823,9702,9764,62,24,0.0614848,1.332416,0.8816349,0.1294225
824,9703,9746,43,12,0.02370561,4.332762,0.7392409,0.1714076
825,9705,9734,29,21,0.07366104,6.305138,1.348313,0.1847515
826,9707,10183,476,13,0.0388645,1.826136,8.931965,0.1346362
827,9709,9724,15,21,0.1490678,6.679247,2.275474,0.1025245
828,9710,9786,76,17,0.2073213,2.978126,1.190372,0.09849955
829,9710,9726,16,12,0.1406602,4.042918,1.077995,0.05851091
830,9710,9727,17,23,0.07314627,0.9507858,1.330908,0.1491981
831,9711,9730,19,13,0.1014892,2.165425,0.7902888,0.1546931
832,9711,9748,37,13,0.02228352,2.353016,0.4108759,0.2192106
833,9712,10240,528,16,0.1132008,2.089061,6.816513,0.1736465
834,9712,9939,227,23,0.008504351,3.119339,2.044931,0.1061178
835,9712,9746,34,25,0.04085649,1.715617,0.8555762,0.07938077
836,9712,9737,25,13,0.03385354,5.442868,1.032404,0.08728191
837,9712,9727,15,14,0.03012449,2.040923,0.3202156,0.2232811
838,9713,9721,8,13,0.2545713,3.160549,1.168627,0.06218281
839,9713,9727,14,15,0.06277055,2.168987,0.4082317,0.1855484
840,9716,9769,53,21,0.02447204,1.709497,1.185674,0.1057287
841,9716,9759,43,16,0.02500272,2.47142,0.3511202,0.177001
842,9717,9729,12,16,0.1826832,1.423128,1.65691,0.1034565
843,9717,9724,7,18,0.256147,1.788508,0.8807244,0.08667667
844,9717,9724,7,16,0.09024042,2.536962,0.4491,0.1048469
845,9717,9724,7,17,0.05328326,3.16857,0.2303121,0.1213544
846,9718,9753,35,22,0.04783997,0.9405409,1.535794,0.1373196
847,9718,9767,49,22,0.06260911,1.91225,1.177802,0.2117166
848,9718,9881,163,22,0.1529086,7.44263,1.835238,0.04192104
849,9718,9729,11,14,0.1173382,1.207549,0.8553942,0.07993779
850,9718,9727,9,18,0.03267425,4.702288,0.3360698,0.1135969
851,9721,9749,28,15,0.06401061,0.7369814,1.829251,0.05623201
852,9724,9840,116,21,0.1092227,3.551404,2.201305,0.08281598
853,9724,9758,34,23,0.02039911,1.453841,0.4486215,0.1007397
854,9725,9748,23,24,0.02980134,1.999051,0.3975675,0.1206775
855,9727,9834,107,25,0.0437783,0.7914019,1.215793,0.1225726
856,9730,9736,6,12,0.2866677,6.55958,1.646369,0.0419307
857,9730,9745,15,18,0.2492891,1.727622,1.709465,0.1078229
858,9731,9786,55,12,0.02584633,3.073157,0.9655982,0.1046619
859,9736,9758,22,17,0.02613161,3.388385,0.4510023,0.1407937
860,9737,9771,34,17,0.01539189,3.616096,0.409739,0.2082689
861,9737,9909,172,18,0.01872811,3.965181,0.6682588,0.09279695
862,9740,9776,36,22,0.05924467,1.044241,1.190569,0.1480374
863,9740,9768,28,26,0.04915715,0.81016,0.9449153,0.1096607
864,9741,9771,30,16,0.05191577,1.923229,1.047877,0.07257074
865,9741,9750,9,18,0.1969033,4.248684,0.8012639,0.1350764
866,9742,9758,16,23,0.101602,1.485448,0.942753,0.2076423
867,9747,9795,48,21,0.02538427,1.145731,1.527406,0.04800563
868,9747,9796,49,25,0.03895988,0.8972559,1.123806,0.1811572
869,9748,9767,19,21,0.1134961,4.974476,0.9551872,0.09924106
870,9749,10377,628,22,0.008460024,1.572745,1.731429,0.0385041
871,9749,9771,22,23,0.09367523,4.918054,2.585349,0.02101181
872,9752,9815,63,16,0.07555054,1.069167,3.279551,0.1490429
873,9753,9799,46,23,0.02872419,0.6974336,0.957377,0.1681254
874,9756,9763,7,18,0.2036636,2.303263,1.348928,0.05420996
875,9756,9853,97,19,0.0165357,5.937723,0.9739367,0.06976826
876,9758,9808,50,22,0.02422325,2.130219,0.7907138,0.03728747
877,9761,10036,275,20,0.01453484,3.553434,1.079455,0.07251692
878,9763,9850,87,22,0.0741041,4.796997,1.939912,0.04193058
879,9765,9852,87,26,0.0368453,0.8707076,1.642713,0.1025878
880,9766,9821,55,22,0.07532933,1.843299,2.731469,0.1647884
881,9767,9853,86,17,0.06526466,1.100539,2.762367,0.03085652
882,9770,10135,365,20,0.04750776,2.642943,2.682826,0.1060243
883,9770,9887,117,17,0.1191847,5.386962,1.997129,0.07729562
884,9772,9888,116,16,0.06797806,3.075031,3.043433,0.09393295
885,9772,9838,66,21,0.05973396,5.331423,1.786382,0.1693635
886,9772,10004,232,23,0.02158342,1.369494,0.8832821,0.05126757
887,9773,9804,31,23,0.07336677,9.90307,1.438274,0.0316002
888,9773,9823,50,23,0.01642099,2.555429,1.104883,0.04937734
889,9779,9813,34,18,0.0568068,4.692121,1.646294,0.04031087
890,9779,9786,7,18,0.2098165,2.405685,0.6839603,0.07030489
891,9780,9870,90,21,0.0535586,1.839354,3.589984,0.07871561
892,9780,9807,27,17,0.1223892,2.956499,3.533695,0.4453103
893,9781,9825,44,21,0.01904554,4.789704,0.6302965,0.09419111
894,9782,9845,63,17,0.05016088,2.336667,3.783344,0.06285809
895,9782,9816,34,22,0.02411957,5.34386,0.3959817,0.09579229
896,9792,9832,40,23,0.05584873,4.360449,2.367393,0.05613066
897,9796,11505,1709,7,0.002495255,2.039929,2.101325,0.2409107
898,9797,9907,110,19,0.01686392,2.525039,0.9821679,0.09583734
899,9799,9923,124,22,0.1240789,2.949131,2.933455,0.1171244
900,9804,9858,54,26,0.02402561,0.9941964,1.177763,0.1605684
901,9805,10084,279,9,0.03069962,1.43496,3.196811,0.1956315
902,9807,9861,54,18,0.0355627,5.925037,1.123728,0.08910856
903,9808,9870,62,18,0.04697285,0.7072788,1.70597,0.04348994
904,9812,9885,73,21,0.0234856,1.065934,1.386502,0.06229314
905,9812,10123,311,17,0.0174081,1.107328,2.684242,0.05354889
906,9813,10109,296,8,0.05234336,5.766379,2.802644,0.4070093
907,9813,10093,280,21,0.01186375,5.271347,0.8923917,0.09760846
908,9814,9826,12,23,0.1902064,9.680884,1.165894,0.05223624
909,9817,9865,48,18,0.2140489,5.199446,2.228167,0.09096289
910,9819,9914,95,16,0.02711393,0.8775562,2.862328,0.05390915
911,9822,9933,111,24,0.01731154,1.631249,0.686383,0.04451786
912,9825,9849,24,22,0.1057442,3.215368,2.413884,0.2784234
913,9826,9898,72,20,0.08856082,4.558068,3.081648,0.1707704
914,9828,9917,89,20,0.01505882,3.489463,1.009464,0.1190972
915,9840,9856,16,23,0.1376415,8.146576,2.425137,0.02789358
916,9846,10033,187,22,0.01171959,0.8167475,0.7423831,0.06925011
917,9849,9928,79,19,0.01413768,3.679708,0.7465663,0.1034262
918,9851,9990,139,18,0.1024848,4.431963,2.514771,0.05802467
919,9852,9873,21,22,0.1027417,4.27733,2.36167,0.2294967
920,9852,9948,96,25,0.02152541,0.8248339,0.761492,0.04748248
921,9853,9872,19,19,0.1294714,5.231122,1.176278,0.1071386
922,9854,9924,70,16,0.03376238,1.785499,2.141784,0.04782124
923,9860,9892,32,21,0.09150942,2.103943,2.409425,0.05546703
924,9860,9898,38,17,0.05906667,0.7039828,1.989518,0.06107465
925,9860,9901,41,18,0.05691275,2.265247,1.301063,0.04150681
926,9864,9912,48,23,0.0673409,3.095455,2.119036,0.08141719
927,9869,9951,82,19,0.04519971,3.259106,1.863642,0.03703386
928,9875,9940,65,24,0.03002557,1.371916,0.92252,0.02635784
929,9880,11078,1198,10,0.006344204,1.895154,3.184069,0.1775204
930,9880,10029,149,23,0.01047372,0.7916005,0.9675512,0.06294888
931,9881,9933,52,23,0.01503022,1.208606,0.7744533,0.06331748
932,9884,10022,138,26,0.009847164,0.7491754,0.6800337,0.03023213
933,9890,10182,292,21,0.02074065,4.585714,0.6832827,0.07825679
934,9892,9910,18,22,0.1328795,3.91774,2.713968,0.3268761
935,9892,10006,114,17,0.1534848,1.95784,9.052014,0.2579309
936,9900,9928,28,25,0.04373597,0.7530326,0.864473,0.03009617
937,9902,16072,6170,23,0.002778191,1.655238,2.180314,0.05733822
938,9902,9931,29,20,0.03983513,2.084774,0.9989473,0.05013464
939,9903,9994,91,21,0.06001427,2.852255,1.380038,0.07450999
940,9904,10045,141,22,0.01311562,6.891353,1.178382,0.08647587
941,9908,11016,1108,10,0.02804515,0.8577724,4.038769,0.1189878
942,9917,9945,28,16,0.09177964,0.6979202,2.365282,0.1246226
943,9918,9985,67,18,0.0588798,5.053248,2.373932,0.08062346
944,9918,9959,41,24,0.01352513,1.127941,0.4546387,0.05409718
945,9919,9948,29,25,0.01910273,0.9747182,0.6022586,0.06162473
946,9931,10120,189,9,0.04864183,5.916846,2.826659,0.3540027
947,9936,10010,74,21,0.03961363,3.796549,3.110656,0.05372475
948,9936,10167,231,23,0.006142511,4.303094,1.530803,0.1199916
949,9941,10117,176,21,0.02944433,3.80396,3.689142,0.0777282
950,9943,10025,82,22,0.0132089,4.561364,0.8933163,0.08800923
951,9945,10014,69,24,0.009224583,1.916812,0.455343,0.06207931
952,9946,10115,169,23,0.01585474,0.9714015,0.6752189,0.089032
953,9946,10004,58,25,0.01100739,1.298143,0.3725925,0.04866772
954,9948,10000,52,18,0.03629101,5.037405,1.487469,0.07114756
955,9957,10197,240,18,0.02882892,0.9060102,2.866351,0.04980724
956,9958,10046,88,21,0.01288294,2.075781,0.7300054,0.09529065
957,9965,10021,56,22,0.03023741,2.47715,1.223402,0.05562021
958,9979,10378,399,9,0.0268337,6.111861,2.771405,0.1393503
959,9985,10034,49,24,0.0249229,1.252955,0.5991532,0.1247483
960,9991,10170,179,9,0.05066327,7.00126,2.250603,0.354379
961,9992,10153,161,22,0.02228896,4.960739,0.7081465,0.1146053
962,10006,10184,178,22,0.005769618,7.624447,0.5231247,0.1262717
963,10015,11295,1280,11,0.01601468,0.917859,3.552714,0.1391809
964,10016,10049,33,23,0.0392754,4.275482,0.749298,0.1281778
965,10022,10487,465,10,0.01052747,5.984685,1.943849,0.1949112
966,10028,10137,109,17,0.1847759,3.00547,4.385313,0.2453426
967,10035,10171,136,22,0.02144126,3.219809,0.8940666,0.08843105
968,10038,10060,22,18,0.2263897,2.699513,3.902075,0.2128319
969,10040,10158,118,24,0.009473751,1.371768,0.6491984,0.1094899
970,10047,10147,100,23,0.01430596,3.776837,1.063606,0.04763057
971,10053,10081,28,22,0.02341667,1.202682,0.5484564,0.02559333
972,10053,10277,224,9,0.05777867,5.460379,3.120779,0.5200992
973,10054,10091,37,23,0.02809956,1.302526,0.4162368,0.02659488
974,10055,10114,59,23,0.03570034,5.498558,0.9722298,0.1714851
975,10069,10090,21,23,0.03787838,3.040788,0.6188533,0.06052211
976,10070,10095,25,24,0.02326886,1.373846,0.3547039,0.03284198
977,10070,10133,63,24,0.01162202,1.809911,0.9271366,0.08989462
978,10071,10085,14,24,0.04107951,1.427087,0.5759189,0.01456342
979,10071,10179,108,25,0.009814893,1.597481,0.3199186,0.02093596
980,10076,10643,567,10,0.01577509,7.791944,3.646016,0.1909418
981,10080,10213,133,24,0.02639955,5.92233,1.252918,0.2294187
982,10082,10105,23,22,0.02494209,6.498315,0.3796767,0.08523811
983,10083,10156,73,25,0.01347658,0.775262,0.4922998,0.1284748
984,10083,10116,33,23,0.01645487,4.868307,0.4232942,0.06807765
985,10084,10130,46,25,0.01528789,1.847588,0.3863648,0.125034
986,10084,10215,131,26,0.008555074,0.6712794,0.4831905,0.17058
987,10104,10203,99,23,0.0289604,4.547187,0.62371,0.1099717
988,10106,10358,252,17,0.1641034,1.678519,9.476333,0.2601654
989,10108,10790,682,23,0.01299875,4.112056,1.277141,0.08513893
990,10111,10136,25,18,0.195788,2.377354,5.313498,0.3573899
991,10111,10167,56,26,0.01067164,0.4164822,0.4703522,0.1278987
992,10112,10174,62,26,0.009472026,1.159177,0.4135783,0.1894758
993,10112,10172,60,27,0.009865733,0.4978131,0.6631856,0.08434319
994,10121,10828,707,22,0.005115297,0.5449158,1.195865,0.07091463
995,10126,10159,33,26,0.008314885,1.971582,0.2158375,0.02727489
996,10127,10325,198,26,0.004812299,2.151609,0.4730882,0.02262626
997,10127,10149,22,27,0.0124471,2.315707,0.1618211,0.0332165
998,10128,10159,31,24,0.0400693,6.186839,0.8607556,0.05859286
999,10128,10145,17,27,0.01530311,2.647146,0.2957999,0.01638728
1000,10128,10141,13,28,0.0208677,2.472821,0.24031,0.02626827
1001,10133,10196,63,22,0.01606182,4.841966,0.6577653,0.04338305
1002,10148,10546,398,25,0.01112968,6.69484,1.276905,0.1994166
1003,10152,10282,130,27,0.004109682,0.8126675,0.5192772,0.2544874
1004,10153,10207,54,27,0.009918248,0.5183479,0.3923875,0.219348
1005,10153,10326,173,28,0.003046172,0.9588956,0.5542704,0.2030434
1006,10161,11453,1292,9,0.0156701,2.187451,3.376022,0.1902927
1007,10165,10189,24,24,0.02387466,3.363242,0.5120942,0.118349
1008,10166,10214,48,25,0.01099366,3.352906,0.6914514,0.1327492
1009,10182,16596,6414,10,0.00373156,1.821084,4.524864,0.09010899
1010,10199,10439,240,10,0.02893585,5.003533,3.375882,0.1469885
1011,10201,11051,850,9,0.01536195,8.585113,4.436859,0.2586583
1012,10216,10512,296,27,0.004168436,1.84163,0.5695487,0.01330033
1013,10217,10294,77,27,0.00678624,2.613747,0.6729369,0.03206826
1014,10265,10545,280,11,0.02126892,10.22116,4.521212,0.2006683
1015,10270,10481,211,11,0.02040973,4.060722,2.706845,0.2773983
1016,10298,10503,205,24,0.006982444,3.530437,0.8662463,0.08974959
1017,10304,11462,1158,11,0.03113919,6.486879,3.659118,0.162151
1018,10313,10636,323,12,0.01519653,1.084522,1.843667,0.1905262
1019,10324,10442,118,26,0.01508511,9.950171,0.7122724,0.1771424
1020,10325,10364,39,27,0.02440405,13.94795,0.9611333,0.2095855
1021,10335,11100,765,13,0.03256092,0.7053201,2.724846,0.1001121
1022,10338,10551,213,9,0.05757539,6.522696,3.232668,0.1020659
1023,10339,11300,961,9,0.04624594,1.240708,5.459378,0.1169294
1024,10363,10427,64,27,0.0137078,10.05317,0.4156462,0.09685674
1025,10364,10424,60,28,0.009922021,11.40528,0.478348,0.0505271
1026,10366,10700,334,28,0.005578186,2.404338,0.7916445,0.01498335
1027,10367,10513,146,28,0.00414116,2.607599,0.483052,0.01778009
1028,10382,10474,92,28,0.01162009,14.71783,0.29366,0.08559386
1029,10383,10448,65,28,0.009100562,8.205723,0.5378017,0.05160212
1030,10383,10452,69,29,0.008576246,13.7409,0.3369009,0.08501642
1031,10400,10536,136,10,0.03012438,2.708272,4.468888,0.2374285
1032,10419,10600,181,26,0.007809873,3.349554,0.9076649,0.1175361
1033,10428,10466,38,29,0.01408914,16.26017,0.3473857,0.08147186
1034,10429,10505,76,29,0.01245691,13.65978,0.3279241,0.1240173
1035,10429,10455,26,30,0.0211001,24.24268,0.4543341,0.09989861
1036,10450,10513,63,24,0.02408322,3.608795,0.7376845,0.08179088
1037,10451,10534,83,25,0.03157502,2.500099,0.9168366,0.09825455
1038,10453,10492,39,25,0.01874026,2.869107,0.4005253,0.101038
1039,10454,10502,48,26,0.01447967,3.050271,0.272749,0.05401732
1040,10455,10474,19,27,0.01954935,1.681912,0.1654322,0.06039447
1041,10456,10776,320,29,0.008610623,1.611872,0.7080532,0.01288599
1042,10458,10562,104,10,0.03168387,6.444927,2.314638,0.09455863
1043,10460,10518,58,30,0.009442151,10.43396,0.4759761,0.1587803
1044,10461,10476,15,30,0.01946535,16.29327,0.2314599,0.08205705
1045,10461,10538,77,27,0.007512992,3.545207,0.3675382,0.07558094
1046,10461,10596,135,31,0.007126131,11.42577,0.4176645,0.21228
1047,10462,10501,39,27,0.01444095,1.602562,0.2188339,0.04808239
1048,10462,10471,9,31,0.03452228,20.95802,0.3060886,0.07740631
1049,10462,10482,20,28,0.01514773,2.136627,0.2056917,0.08606454
1050,10463,10486,23,28,0.01268055,1.605766,0.1551071,0.06159819
1051,10463,10483,20,29,0.01453081,1.413025,0.158583,0.07130461
1052,10466,10519,53,26,0.03601383,1.750238,1.230907,0.129836
1053,10481,10512,31,28,0.01721137,1.17269,0.3198598,0.04820061
1054,10481,10508,27,27,0.06611767,1.425716,0.6252177,0.1858999
1055,10482,10508,26,28,0.01040476,1.382304,0.1493694,0.06308541
1056,10482,10496,14,29,0.021233,1.687958,0.205887,0.04307704
1057,10482,10495,13,28,0.05257637,1.732906,0.4956073,0.1008309
1058,10483,10520,37,28,0.00668833,2.16129,0.2598076,0.04906264
1059,10483,10500,17,29,0.008125642,1.297963,0.1095332,0.08864274
1060,10483,10499,16,30,0.0158683,2.189847,0.1124207,0.02882503
1061,10484,10516,32,30,0.003836346,0.687489,0.1136546,0.1325887
1062,10492,11121,629,14,0.02344621,1.049578,3.908274,0.1462618
1063,10492,10599,107,28,0.05334015,1.453088,0.8818173,0.1520222
1064,10494,11275,781,9,0.01859391,2.214966,2.093219,0.1386371
1065,10495,10840,345,13,0.01282942,1.355055,1.382703,0.1044092
1066,10498,10563,65,26,0.01712431,2.114468,0.7512299,0.1406966
1067,10502,10552,50,29,0.02552097,1.254468,1.04054,0.09413118
1068,10507,10921,414,10,0.01933648,2.06785,2.20986,0.2003746
1069,10518,10527,9,29,0.08013909,1.537479,0.5204619,0.1284517
1070,10519,10526,7,30,0.09501394,1.943095,0.4344413,0.1164682
1071,10520,10578,58,32,0.009447296,7.907525,0.2599518,0.1522646
1072,10521,10630,109,32,0.004885325,8.015812,0.2717202,0.1693371
1073,10521,10591,70,33,0.007648945,5.127373,0.3434215,0.1999024
1074,10528,10609,81,30,0.01713204,1.535211,0.8012395,0.01541885
1075,10533,10745,212,24,0.006292759,2.789178,1.51691,0.102706
1076,10535,10992,457,23,0.004402337,0.6481711,0.9617924,0.1054584
1077,10541,10646,105,29,0.0414768,1.670454,1.079394,0.09170952
1078,10547,10652,105,10,0.02602457,1.945385,1.268144,0.08512562
1079,10549,11163,614,14,0.01230848,1.234688,1.651231,0.08117883
1080,10557,12029,1472,11,0.01151274,1.691483,2.849206,0.1346661
1081,10561,10618,57,29,0.03113571,1.827409,0.9735487,0.2121271
1082,10563,10726,163,11,0.01362387,2.302362,1.191323,0.1026404
1083,10577,10892,315,14,0.02975713,0.9043264,3.235202,0.1423075
1084,10578,10626,48,29,0.0221694,2.04443,0.5670979,0.2214238
1085,10578,10705,127,30,0.05480231,2.578272,1.306325,0.2001021
1086,10582,10711,129,30,0.01452516,1.176698,0.9589874,0.01677497
1087,10583,10797,214,30,0.00338507,0.8076323,0.5091894,0.01176372
1088,10588,10614,26,31,0.05385784,1.757498,1.490652,0.186678
1089,10590,11175,585,8,0.003775818,1.660013,1.339388,0.1603379
1090,10591,10764,173,11,0.02229587,1.955726,1.223164,0.06951825
1091,10597,10655,58,30,0.03466556,1.594374,0.9360446,0.06899302
1092,10600,11385,785,31,0.00794905,1.655092,1.422605,0.01278051
1093,10603,11077,474,9,0.02081029,1.980194,5.577921,0.09849112
1094,10603,10781,178,12,0.009365569,1.498021,1.511432,0.07219021
1095,10611,10648,37,30,0.05599423,2.211705,1.090173,0.09689749
1096,10613,12449,1836,10,0.006256705,8.657494,2.760655,0.2782637
1097,10613,10648,35,31,0.0416555,1.895971,0.7953452,0.1024352
1098,10622,10883,261,31,0.02320533,2.01525,1.533605,0.1225442
1099,10623,11298,675,9,0.005133508,2.03283,1.062551,0.1602279
1100,10630,10708,78,31,0.04571063,3.80858,1.561382,0.25021
1101,10633,10956,323,15,0.02939758,0.6382871,3.917623,0.08937245
1102,10635,10751,116,32,0.01340083,2.011138,2.288445,0.141394
1103,10650,10844,194,30,0.002795489,2.099974,0.3787297,0.01708395
1104,10651,11057,406,31,0.001322014,2.750097,0.4994304,0.02435573
1105,10652,11350,698,24,0.003153045,0.6707883,0.8577428,0.130217
1106,10668,11395,727,14,0.01698206,0.5968047,2.345659,0.08873539
1107,10675,10981,306,15,0.01560579,1.743373,1.551837,0.116419
1108,10676,10740,64,31,0.0238386,3.676527,0.7804551,0.2658021
1109,10684,11395,711,12,0.0133019,1.454579,1.768126,0.03854778
1110,10686,10963,277,13,0.01613034,2.179307,1.35727,0.0539318
1111,10708,10857,149,14,0.01188863,3.207123,1.740833,0.05360479
1112,10709,10955,246,16,0.007263454,2.517666,1.234945,0.1722696
1113,10729,11794,1065,11,0.002204176,2.372202,2.274891,0.06021854
1114,10730,13913,3183,12,0.001365035,1.815007,3.074786,0.05151688
1115,10740,11648,908,10,0.01261421,3.2096,2.532842,0.2055241
1116,10795,11051,256,11,0.01627835,0.8033566,4.74385,0.1443141
1117,10800,12235,1435,13,0.003892461,1.61597,2.413181,0.03490659
1118,10803,10993,190,32,0.02682212,2.264654,0.9481675,0.1185487
1119,10810,11067,257,16,0.02438031,0.4062241,5.189983,0.07532426
1120,10829,11162,333,15,0.01838885,1.010031,2.114104,0.08023078
1121,10834,10911,77,33,0.01978084,2.838483,0.7989432,0.1625488
1122,10842,11049,207,10,0.02034454,2.585439,2.056296,0.09463377
1123,10848,11151,303,10,0.004853901,1.889326,1.170061,0.1728554
1124,10859,10913,54,14,0.03153564,1.776641,1.576717,0.03342263
1125,10861,11018,157,15,0.03904209,0.8014687,2.762189,0.1486295
1126,10879,10975,96,16,0.01647774,1.239201,1.004403,0.1378817
1127,10882,10956,74,33,0.01524283,2.26716,1.246283,0.08855392
1128,10893,11286,393,32,0.004166367,1.125916,1.521403,0.01576398
1129,10921,11050,129,33,0.03254767,2.612395,1.310835,0.09305425
1130,10933,10974,41,34,0.03342149,2.571338,1.359582,0.1016923
1131,10939,11231,292,25,0.00444134,0.9631037,0.7987043,0.1483356
1132,10946,11022,76,11,0.01917065,3.019616,1.311949,0.2118409
1133,10947,11059,112,12,0.01269013,1.593064,0.9268898,0.1847104
1134,10949,11112,163,33,0.02073689,3.191097,1.361427,0.06934644
1135,10956,11308,352,12,0.009144452,1.703735,2.407841,0.0861612
1136,10963,11285,322,10,0.02349443,0.6898357,8.009089,0.1593681
1137,11001,11104,103,34,0.02781516,3.391014,1.202879,0.1152957
1138,11007,11492,485,14,0.03187066,0.7759959,3.326853,0.132018
1139,11024,11074,50,35,0.0151798,1.928647,0.6268374,0.1206764
1140,11025,11144,119,34,0.04307507,3.45114,1.209313,0.08666053
1141,11025,11072,47,36,0.01865468,2.327319,0.5894111,0.1323522
1142,11028,11068,40,36,0.0174754,2.186479,0.5782738,0.1256785
1143,11029,11083,54,36,0.01256589,2.182286,0.8490994,0.1576468
1144,11029,11085,56,37,0.0121464,1.649632,0.4071475,0.1769209
1145,11037,11065,28,37,0.0244593,1.683802,0.5840475,0.1831709
1146,11038,11085,47,37,0.01340784,1.312071,0.7725112,0.1504439
1147,11038,11072,34,38,0.01888613,1.431141,0.8006095,0.2641771
1148,11050,11178,128,10,0.01706542,1.31633,2.490046,0.1721813
1149,11057,11370,313,35,0.02346179,4.357954,1.620197,0.07640544
1150,11069,11997,928,12,0.02548827,7.610726,3.170809,0.08972203
1151,11070,11668,598,10,0.001947063,2.209991,1.549377,0.08502854
1152,11089,11141,52,35,0.02998937,3.685917,0.9913809,0.1039984
1153,11096,11613,517,10,0.01082572,1.615078,4.269763,0.280336
1154,11110,11342,232,13,0.0151192,7.964325,1.741716,0.08560148
1155,11114,11188,74,35,0.02758575,2.051217,0.8995192,0.08064759
1156,11116,11234,118,15,0.02319489,0.3781897,2.217312,0.1026041
1157,11125,11439,314,36,0.03703538,4.085683,1.935243,0.1015898
1158,11127,11365,238,15,0.02361149,0.3970661,2.791193,0.1841783
1159,11143,11283,140,36,0.032382,1.226679,1.239944,0.1057004
1160,11152,11286,134,37,0.01099542,1.438955,1.017535,0.1546346
1161,11166,11282,116,32,0.01511609,0.8527595,1.680217,0.008089418
1162,11180,11285,105,37,0.01880764,0.7258542,0.8709237,0.06741233
1163,11196,11701,505,13,0.01867946,2.137943,2.594037,0.0482344
1164,11200,11396,196,36,0.01866586,4.424245,2.085128,0.0966486
1165,11208,11582,374,12,0.02644747,4.427516,4.881574,0.1893785
1166,11212,11245,33,38,0.02127447,1.002271,0.6037756,0.07007082
1167,11213,11241,28,39,0.02456041,0.8928897,0.4181271,0.05139569
1168,11221,11401,180,37,0.02473812,4.939263,1.570939,0.0899908
1169,11228,11292,64,38,0.03191503,3.057892,1.786756,0.1204806
1170,11249,11301,52,38,0.04256844,6.529275,0.8874825,0.09391783
1171,11256,11698,442,13,0.008696557,1.818231,2.020127,0.04693511
1172,11262,11460,198,39,0.04941338,8.78076,1.311778,0.1180228
1173,11265,11393,128,37,0.01906495,2.446818,1.686557,0.08579522
1174,11272,11747,475,13,0.01298579,7.373679,2.444789,0.09804656
1175,11272,11368,96,37,0.05633505,5.028623,1.159976,0.1470693
1176,11274,11294,20,40,0.08038063,7.077466,1.834211,0.1095263
1177,11279,11407,128,36,0.03726419,5.943305,1.181264,0.08958687
1178,11300,11321,21,38,0.06519981,6.279847,1.702346,0.1047235
1179,11311,11672,361,14,0.01153647,8.37182,2.403455,0.1124734
1180,11315,11357,42,37,0.03355963,4.621209,0.98115,0.1287339
1181,11318,11520,202,38,0.02003311,4.551031,2.01865,0.08643582
1182,11323,11873,550,14,0.01462304,2.648647,1.386229,0.06454159
1183,11324,11446,122,15,0.01258969,2.753449,1.147037,0.08628255
1184,11339,11357,18,38,0.04900613,3.101124,0.644411,0.2199188
1185,11340,11349,9,39,0.09893099,1.750389,0.7803149,0.17353
1186,11358,11411,53,40,0.03247022,8.307838,1.381769,0.1248477
1187,11377,11396,19,40,0.07879523,7.335145,1.654971,0.06284461
1188,11384,12228,844,13,0.01783929,6.73252,4.176995,0.102577
1189,11432,11539,107,40,0.05419492,8.256732,1.38576,0.1352684
1190,11459,11945,486,15,0.0169404,8.376219,1.83015,0.1457363
1191,11470,11503,33,41,0.07988919,11.89296,0.8364279,0.07564079
1192,11475,14426,2951,2,0.007349696,3.38217,11.01705,0.4982514
1193,11488,11503,15,42,0.07903523,7.862576,0.5482987,0.08018339
1194,11491,11768,277,16,0.02392722,4.799223,1.380647,0.213959
1195,11494,11753,259,13,0.01282356,7.594286,3.53423,0.05298833
1196,11513,11560,47,17,0.03748485,3.160932,1.579168,0.1577521
1197,11519,11917,398,14,0.007415014,6.46385,3.294788,0.09594053
1198,11568,12725,1157,14,0.002242575,2.386375,2.937166,0.04292081
1199,11572,13710,2138,5,0.009808527,3.515966,5.63253,0.2107329
1200,11592,11678,86,17,0.02261859,7.03166,1.63736,0.2971838
1201,11603,11849,246,15,0.02467619,3.430508,1.539687,0.06725077
1202,11607,12011,404,16,0.004951858,11.29216,2.135022,0.1745538
1203,11618,12075,457,16,0.01976947,3.845076,1.333524,0.06750195
1204,11693,11767,74,17,0.03459328,4.36755,1.175617,0.2252456
1205,11717,11908,191,16,0.01089816,10.42738,1.038239,0.2017648
1206,11726,12841,1115,17,0.01389162,5.585431,1.83504,0.09788744
1207,11730,11959,229,18,0.03244834,2.796395,1.079754,0.2498645
1208,11745,11852,107,19,0.01303583,1.423647,1.233663,0.1428781
1209,11749,11835,86,15,0.02112502,3.312344,0.9379711,0.08393604
1210,11755,12115,360,13,0.03160189,4.089527,4.455164,0.1152886
1211,11756,12115,359,14,0.01785432,4.213862,4.569116,0.1365321
1212,11767,11888,121,17,0.009224846,3.483655,0.7431147,0.07671124
1213,11778,12269,491,12,0.005857613,1.975916,1.743854,0.1206203
1214,11779,11916,137,19,0.01356127,3.476988,0.9307243,0.162277
1215,11800,11940,140,18,0.005748304,2.3178,0.4857779,0.08371586
1216,11801,11978,177,18,0.004487508,4.878126,0.8051809,0.08458163
1217,11801,11845,44,19,0.009515175,1.850547,0.3723028,0.09347707
1218,11802,11845,43,20,0.009397354,2.159885,0.531215,0.1177652
1219,11813,11978,165,16,0.01457332,4.888799,1.457718,0.1000532
1220,11818,11986,168,20,0.007825145,3.39183,0.7130904,0.2395884
1221,11850,12000,150,17,0.01386954,4.218515,1.734666,0.08189709
1222,11855,11926,71,19,0.01932137,3.529952,1.446739,0.2560567
1223,11870,12185,315,18,0.005690239,6.279293,1.654337,0.08739736
1224,11871,11967,96,13,0.03358393,6.116584,2.647951,0.05942629
1225,11884,12330,446,17,0.01318169,3.040977,1.540804,0.0578309
1226,11917,12819,902,18,0.01435361,4.172063,2.148495,0.07770143
1227,11932,12508,576,11,0.00561399,10.2485,1.692179,0.3105448
1228,11964,13791,1827,18,0.005219829,3.816245,2.68505,0.1057747
1229,11981,12047,66,17,0.01426059,3.481714,0.8634177,0.03601197
1230,11982,12126,144,18,0.02046872,2.706934,1.036589,0.02688682
1231,12166,12929,763,18,0.01057193,3.530874,1.815237,0.08466884
1232,12260,12596,336,18,0.006163329,6.699805,2.729889,0.1257536
1233,12388,12530,142,19,0.015848,4.35698,1.343055,0.05212953
1234,12390,12468,78,20,0.01433653,4.743967,0.911787,0.07128191
1235,12391,12543,152,21,0.01294039,3.563532,0.710212,0.04476718
1236,12400,12562,162,18,0.01283257,4.818627,2.394661,0.1395883
1237,12454,12530,76,22,0.007717176,4.236128,0.4196875,0.05070742
1238,12455,12564,109,23,0.007359432,2.813333,0.2999251,0.0318771
1239,12481,12600,119,24,0.005056255,3.514175,0.3369815,0.03207244
1240,12482,12507,25,24,0.01281206,1.949232,0.178436,0.03552877
1241,12482,12579,97,25,0.003096611,1.762141,0.219193,0.02669206
1242,12483,12505,22,25,0.01385775,2.211953,0.206681,0.02715683
1243,12483,12587,104,26,0.00285487,1.319143,0.2009947,0.02049549
1244,12522,12829,307,19,0.01387988,4.33928,1.183598,0.05115011
1245,12546,12744,198,18,0.0114264,5.404354,1.105875,0.1148833
1246,12587,12920,333,19,0.01207149,8.021332,1.531461,0.1328304
1247,12621,16908,4287,24,0.003983958,2.099527,2.806325,0.07635523
1248,12701,12795,94,18,0.02085805,4.490361,2.018615,0.05939984
1249,12729,13094,365,19,0.01126569,2.649339,2.316833,0.09479977
1250,12771,13388,617,20,0.005160395,6.448205,1.051607,0.1716804
1251,12813,13340,527,21,0.008088754,5.179343,1.536578,0.1345499
1252,12850,13905,1055,22,0.004124111,6.653979,1.43688,0.07348574
1253,12888,14458,1570,19,0.003988119,4.956201,2.412452,0.07704327
1254,12970,13787,817,21,0.002499253,5.333425,1.19165,0.1189576
1255,12999,13808,809,23,0.004181889,5.864242,1.715713,0.06669815
1256,13118,13590,472,22,0.003794191,6.964174,1.648705,0.129848
1257,13128,13381,253,21,0.005300953,4.471141,0.7066398,0.2100776
1258,13207,13758,551,22,0.001316404,3.95006,0.6353849,0.0994319
1259,13208,13762,554,23,0.001308579,5.173409,0.9110223,0.06076383
1260,13284,14314,1030,24,0.007714062,5.959458,1.939281,0.05031673
1261,13460,14058,598,23,0.003068482,5.780606,1.412234,0.08700893
1262,13467,15069,1602,5,0.01803923,1.400986,11.56614,0.1747112
1263,13540,13719,179,25,0.01187149,3.336701,1.262476,0.04429995
1264,13616,14112,496,25,0.004174048,2.018276,1.432516,0.05785198
1265,13617,14457,840,26,0.001865699,1.342878,1.215262,0.04645237
1266,13679,15378,1699,24,0.001568961,1.735474,1.607796,0.0432866
1267,13744,16195,2451,25,0.0009268918,1.750785,1.847939,0.03450336
1268,13751,14425,674,26,0.002233076,2.331667,0.998722,0.08572678
1269,13775,14438,663,25,0.009292269,5.422096,2.89457,0.04045096
1270,13843,14432,589,20,0.004167205,7.174186,3.274018,0.1098555
1271,14237,16066,1829,11,0.007219507,1.883855,2.593499,0.09487142
1272,14268,27451,13183,5,0.006194262,3.394364,11.59887,0.233713
1273,14287,15020,733,25,0.002337797,0.923216,0.947603,0.03058677
1274,14361,15757,1396,12,0.004984166,1.310718,3.394972,0.04901009
1275,14439,15395,956,25,0.003065087,1.083664,3.589208,0.1097111
1276,15142,15887,745,12,0.01164148,1.512481,3.013717,0.06508604
1277,16129,18658,2529,25,0.003833655,2.186377,3.379276,0.04404869
1278,17768,18965,1197,26,0.006466544,2.50558,3.671746,0.04182697
1279,18395,19244,849,27,0.006694627,1.841924,2.960851,0.03947287
1280,18718,23285,4567,6,0.009760688,2.576721,10.79382,0.1341488
1281,19684,25650,5966,7,0.006896798,1.67821,14.01961,0.1776104
1282,23962,25349,1387,6,0.009221421,4.339565,6.386129,0.1541832
1283,24391,26216,1825,7,0.01106805,2.226877,3.927658,0.171253
1284,24434,26239,1805,8,0.00541991,2.719998,2.927645,0.1798541
1285,24693,25587,894,9,0.005372787,2.634517,2.265184,0.242869
1286,24731,25150,419,10,0.00620815,2.580806,2.727193,0.3171454
1287,24807,26217,1410,8,0.007116769,1.465196,5.430517,0.1040728
1288,25312,25910,598,9,0.005054811,2.121472,3.473298,0.1128616
1289,25318,25707,389,8,0.01327266,2.934225,2.890137,0.1102258
1290,25326,26351,1025,9,0.006879119,3.041214,3.941296,0.1633888
1291,25829,26211,382,8,0.01120119,3.235145,4.250077,0.2338438
